ⲡ ⲛⲟⲩⲧⲉ	ⲛⲟⲩⲧⲉ	213
ⲡ ϫⲟⲉⲓⲥ	ϫⲟⲉⲓⲥ	79
ⲡⲁⲓ	ⲡⲁⲓ	74
ⲛⲁⲓ	ⲛⲁⲓ	61
ⲡⲉ ⲭⲣⲓⲥⲧⲟⲥ	ⲭⲣⲓⲥⲧⲟⲥ	40
ⲓⲏⲥⲟⲩⲥ	ⲓⲏⲥⲟⲩⲥ	39
ⲗⲁⲁⲩ	ⲗⲁⲁⲩ	38
ⲡ ⲣⲱⲙⲉ	ⲣⲱⲙⲉ	36
ⲡⲉⲓ ⲙⲁ	ⲙⲁ	32
ⲛ ⲣⲱⲙⲉ	ⲣⲱⲙⲉ	25
ⲃⲟⲉⲥ	ⲃⲟⲉⲥ	24
ⲛⲉϥ ⲙⲁⲑⲏⲧⲏⲥ	ⲙⲁⲑⲏⲧⲏⲥ	24
ⲛⲟⲉⲙⲓⲛ	ⲛⲟⲉⲙⲓⲛ	23
ⲡ ⲕⲁϩ	ⲕⲁϩ	23
ⲡ ϩⲗⲗⲟ	ϩⲗⲗⲟ	23
ⲧⲁⲓ	ⲧⲁⲓ	22
ⲡ ⲕⲟⲥⲙⲟⲥ	ⲕⲟⲥⲙⲟⲥ	21
ⲡ ⲙⲏⲏϣⲉ	ⲙⲏⲏϣⲉ	20
ⲡ ϣⲁϫⲉ	ϣⲁϫⲉ	20
ⲟⲩⲁ	ⲟⲩⲁ	19
ⲡ ⲣⲣⲟ	ⲣⲣⲟ	18
ϩⲣⲟⲩⲑ	ϩⲣⲟⲩⲑ	16
ⲟⲩ ϩⲗⲗⲟ	ϩⲗⲗⲟ	16
ⲛⲉ ⲥⲛⲏⲩ	ⲥⲛⲏⲩ	16
ⲡⲉ ϩⲟⲟⲩ	ϩⲟⲟⲩ	16
ⲓⲱϩⲁⲛⲛⲏⲥ	ⲓⲱϩⲁⲛⲛⲏⲥ	16
ⲡ ⲙⲁ ⲉⲧ ⲙⲙⲁⲩ	ⲙⲁ	15
ⲡ ϫⲟⲉⲓ	ϫⲟⲉⲓ	15
ⲡⲁ ϩⲏⲧ	ϩⲏⲧ	14
ⲛ ϩⲏⲕⲉ	ϩⲏⲕⲉ	14
ⲧⲉ ⲩϣⲏ	ⲩϣⲏ	14
ϩⲱⲃ ⲛⲓⲙ	ϩⲱⲃ	14
ⲛⲁ ⲥⲛⲏⲩ	ⲥⲛⲏⲩ	13
ϩⲉⲛ ⲕⲟⲟⲩⲉ	ⲕⲟⲟⲩⲉ	13
ⲡⲁ ϣⲏⲣⲉ	ϣⲏⲣⲉ	13
ⲓⲁⲕⲱⲃ	ⲓⲁⲕⲱⲃ	13
ⲡ ⲥⲁⲧⲁⲛⲁⲥ	ⲥⲁⲧⲁⲛⲁⲥ	12
ⲙ ⲡⲏⲩⲉ	ⲡⲏⲩⲉ	12
ⲡⲉϥ ⲉⲓⲱⲧ	ⲉⲓⲱⲧ	12
ⲟⲩ ⲣⲱⲙⲉ	ⲣⲱⲙⲉ	11
ⲡ ⲥⲱⲙⲁ	ⲥⲱⲙⲁ	11
ⲧⲉ ⲑⲁⲗⲁⲥⲥⲁ	ⲑⲁⲗⲁⲥⲥⲁ	11
ⲟⲩ ⲥⲟⲛ	ⲥⲟⲛ	11
ⲡ ⲣⲟ	ⲣⲟ	11
ⲧ ⲡⲉ	ⲡⲉ	11
ⲡⲉ ⲡⲛⲉⲩⲙⲁ	ⲡⲛⲉⲩⲙⲁ	10
ⲧⲁ ϣⲉⲉⲣⲉ	ϣⲉⲉⲣⲉ	10
ⲣⲱⲙⲉ	ⲣⲱⲙⲉ	10
ⲡⲉϥ ⲣⲁⲛ	ⲣⲁⲛ	10
ⲡ ⲕⲁⲕⲉ	ⲕⲁⲕⲉ	10
ⲧ ⲙⲛⲧⲣⲣⲟ ⲙ ⲡ ⲛⲟⲩⲧⲉ	ⲙⲛⲧⲣⲣⲟ	10
ⲧⲉⲥ ϣⲱⲙⲉ	ϣⲱⲙⲉ	10
ⲡⲉ ⲑⲃⲃⲓⲟ	ⲑⲃⲃⲓⲟ	10
ⲛⲉ ⲫⲁⲣⲓⲥⲥⲁⲓⲟⲥ	ⲫⲁⲣⲓⲥⲥⲁⲓⲟⲥ	10
ⲟⲩⲟⲉⲓϣ ⲛⲓⲙ	ⲟⲩⲟⲉⲓϣ	10
ⲡ ⲥⲟⲛ	ⲥⲟⲛ	10
ϣⲓⲏⲧ	ϣⲓⲏⲧ	10
ϭⲟⲛⲥ	ϭⲟⲛⲥ	10
ϩⲟⲓⲛⲉ	ϩⲟⲓⲛⲉ	9
ⲧ ϣⲉⲉⲣⲉ ϣⲏⲙ	ϣⲉⲉⲣⲉ	9
ⲛⲟⲩⲃ	ⲛⲟⲩⲃ	9
ⲧⲉϥ ⲙⲁⲁⲩ	ⲙⲁⲁⲩ	9
ⲡ ⲧⲟⲟⲩ	ⲧⲟⲟⲩ	9
ⲡ ⲅⲉⲛⲟⲥ	ⲅⲉⲛⲟⲥ	9
ⲡⲉⲕ ⲥⲟⲛ	ⲥⲟⲛ	9
ⲡⲉⲕ ⲏⲓ	ⲏⲓ	9
ⲧ ⲡⲟⲗⲓⲥ	ⲡⲟⲗⲓⲥ	9
ⲛⲉ ⲅⲣⲁⲙⲙⲁⲧⲉⲩⲥ	ⲅⲣⲁⲙⲙⲁⲧⲉⲩⲥ	9
ⲡ ϩⲟⲟⲩ	ϩⲟⲟⲩ	9
ⲡ ⲇⲓⲁⲃⲟⲗⲟⲥ	ⲇⲓⲁⲃⲟⲗⲟⲥ	9
ⲙⲱⲁⲃ	ⲙⲱⲁⲃ	8
ϩⲁϩ ⲛ ⲥⲟⲡ	ⲥⲟⲡ	8
ⲧ ⲅⲁⲗⲓⲗⲁⲓⲁ	ⲅⲁⲗⲓⲗⲁⲓⲁ	8
ⲟⲩⲟⲛ ⲛⲓⲙ	ⲟⲩⲟⲛ	8
ⲡⲉϥ ⲏⲓ	ⲏⲓ	8
ⲡⲉⲛ ϫⲟⲉⲓⲥ ⲓⲏⲥⲟⲩⲥ ⲡⲉ ⲭⲣⲓⲥⲧⲟⲥ	ⲓⲏⲥⲟⲩⲥ	8
ⲡⲉⲧⲣⲟⲥ	ⲡⲉⲧⲣⲟⲥ	8
ⲧⲉ ϩⲓⲏ	ϩⲓⲏ	8
ϩⲉⲛ ϣⲏⲣⲉ	ϣⲏⲣⲉ	8
ⲡ ⲓⲥⲣⲁⲏⲗ	ⲓⲥⲣⲁⲏⲗ	8
ⲡ ⲏⲓ	ⲏⲓ	8
ⲡ ⲛⲁ	ⲛⲁ	8
ⲧ ⲥⲱϣⲉ ⲙ ⲙⲱⲁⲃ	ⲥⲱϣⲉ	7
ϩⲧⲟⲟⲩⲉ	ϩⲧⲟⲟⲩⲉ	7
ⲛ ⲉⲧ ⲟⲩⲁⲁⲃ	ⲛ	7
ⲡ ⲟⲩⲁ ⲡ ⲟⲩⲁ	ⲟⲩⲁ	7
ⲡⲁⲩⲗⲟⲥ	ⲡⲁⲩⲗⲟⲥ	7
ⲡⲁ ⲉⲓⲱⲧ	ⲉⲓⲱⲧ	7
ⲥⲓⲙⲱⲛ	ⲥⲓⲙⲱⲛ	7
ⲡ ϫⲁϫⲉ	ϫⲁϫⲉ	7
ϩⲏⲣⲱⲇⲏⲥ	ϩⲏⲣⲱⲇⲏⲥ	7
ⲧ ⲥⲩⲛⲁⲅⲱⲅⲏ	ⲥⲩⲛⲁⲅⲱⲅⲏ	7
ⲡⲉϥ ϩⲏⲧ	ϩⲏⲧ	6
ⲧ ⲉⲣⲏⲙⲟⲥ	ⲉⲣⲏⲙⲟⲥ	6
ⲉⲛⲉϩ	ⲉⲛⲉϩ	6
ⲟⲉⲓⲕ	ⲟⲉⲓⲕ	6
ⲓⲁⲕⲱⲃⲟⲥ	ⲓⲁⲕⲱⲃⲟⲥ	6
ⲙⲱⲩⲥⲏⲥ	ⲙⲱⲩⲥⲏⲥ	6
ⲡⲉϥ ⲥⲟⲛ	ⲥⲟⲛ	6
ⲡ ϣⲏⲣⲉ ⲙ ⲡ ⲣⲱⲙⲉ	ϣⲏⲣⲉ	6
ⲇⲁⲓⲙⲱⲛⲓⲟⲛ	ⲇⲁⲓⲙⲱⲛⲓⲟⲛ	6
ⲡ ⲟⲩⲟⲉⲓⲛ	ⲟⲩⲟⲉⲓⲛ	6
ⲡⲁ ⲣⲁⲛ	ⲣⲁⲛ	6
ⲧ ⲥⲱϣⲉ	ⲥⲱϣⲉ	6
ⲡⲉⲕ ϩⲏⲧ	ϩⲏⲧ	6
ⲧⲉϥ ϭⲓϫ	ϭⲓϫ	6
ⲡⲉⲓ ⲁⲓⲱⲛ	ⲁⲓⲱⲛ	6
ⲓⲥⲁⲁⲕ	ⲓⲥⲁⲁⲕ	6
ⲡⲉϥ ⲥⲱⲙⲁ	ⲥⲱⲙⲁ	6
ⲡ ⲙⲟⲩ	ⲙⲟⲩ	6
ⲡ ⲟⲩⲉ	ⲟⲩⲉ	6
ⲡ ⲁⲡⲟⲗⲗⲱⲛ	ⲁⲡⲟⲗⲗⲱⲛ	6
ⲩ ⲥⲟⲛ	ⲥⲟⲛ	6
ϩⲏⲗⲉⲓⲁⲥ	ϩⲏⲗⲉⲓⲁⲥ	6
ⲁⲡⲟⲗⲗⲱ	ⲁⲡⲟⲗⲗⲱ	6
ⲕⲉ ⲥⲟⲡ	ⲥⲟⲡ	6
ⲛⲉ ⲅⲣⲁⲫⲏ	ⲅⲣⲁⲫⲏ	6
ⲉⲓⲁⲧ ϥ	ⲉⲓⲁⲧ	5
ⲧ ϩⲟⲧⲉ ⲙ ⲡ ⲛⲟⲩⲧⲉ	ϩⲟⲧⲉ	5
ⲁⲡⲁ ⲡⲁⲙⲃⲱ	ⲡⲁⲙⲃⲱ	5
ⲕⲁⲕⲉ	ⲕⲁⲕⲉ	5
ⲙⲟⲟⲩ	ⲙⲟⲟⲩ	5
ⲧⲉϥ ⲯⲩⲭⲏ	ⲯⲩⲭⲏ	5
ⲟⲩ ϭⲟⲙ	ϭⲟⲙ	5
ⲡ ⲕⲱϩⲧ	ⲕⲱϩⲧ	5
ⲛⲉ ⲡⲣⲟⲫⲏⲧⲏⲥ	ⲡⲣⲟⲫⲏⲧⲏⲥ	5
ⲧ ⲙⲛⲧⲙⲟⲛⲁⲭⲟⲥ	ⲙⲛⲧⲙⲟⲛⲁⲭⲟⲥ	5
ϩⲣⲁⲭⲏⲗ	ϩⲣⲁⲭⲏⲗ	5
ⲃⲏⲑⲗⲉⲉⲙ	ⲃⲏⲑⲗⲉⲉⲙ	5
ⲁⲡⲁ ϫⲓϫⲱⲓ	ϫⲓϫⲱⲓ	5
ⲩ ⲥϩⲓⲙⲉ	ⲥϩⲓⲙⲉ	5
ⲡⲉⲓ ⲕⲟⲥⲙⲟⲥ	ⲕⲟⲥⲙⲟⲥ	5
ⲛ ⲥⲁⲃⲃⲁⲧⲟⲛ	ⲥⲁⲃⲃⲁⲧⲟⲛ	5
ⲡ ⲥⲁ ⲛϩⲟⲩⲛ	ⲥⲁ	5
ⲧ ⲑⲁⲗⲁⲥⲥⲁ	ⲑⲁⲗⲁⲥⲥⲁ	5
ⲡ ⲡⲉⲧⲛⲁⲛⲟⲩϥ	ⲡⲉⲧⲛⲁⲛⲟⲩϥ	5
ⲡⲉ ⲕⲣⲟ	ⲕⲣⲟ	5
ⲡⲉⲓ ϩⲱⲃ	ϩⲱⲃ	5
ϭⲟⲙ	ϭⲟⲙ	5
ⲡⲉⲛ ϩⲏⲧ	ϩⲏⲧ	5
ⲧ ⲉⲝⲟⲩⲥⲓⲁ	ⲉⲝⲟⲩⲥⲓⲁ	5
ⲛ ϩⲉⲗⲗⲏⲛ	ϩⲉⲗⲗⲏⲛ	5
ⲧⲉⲩ ⲙⲏⲧⲉ	ⲙⲏⲧⲉ	5
ⲩ ⲛⲟϭ ⲙ ⲙⲏⲏϣⲉ	ⲙⲏⲏϣⲉ	5
ⲡⲉⲩ ϩⲏⲧ	ϩⲏⲧ	5
ⲡ ϫⲓⲛϫⲏ	ϫⲓⲛϫⲏ	5
ⲡⲉⲛ ϫⲟⲉⲓⲥ ⲓⲏⲥⲟⲩⲥ	ⲓⲏⲥⲟⲩⲥ	5
ⲡ ϩⲁⲡ	ϩⲁⲡ	5
ⲙⲁ ⲛⲓⲙ	ⲙⲁ	5
ⲡ ⲣⲡⲉ	ⲣⲡⲉ	5
ⲛⲉϥ ϩⲟⲓⲧⲉ	ϩⲟⲓⲧⲉ	5
ⲡ ⲥⲁⲃⲃⲁⲧⲟⲛ	ⲥⲁⲃⲃⲁⲧⲟⲛ	5
ⲛⲁ ⲛⲟⲩⲧⲉ	ⲛⲟⲩⲧⲉ	5
ⲛⲉ ⲡⲣⲉⲥⲃⲩⲧⲉⲣⲟⲥ	ⲡⲣⲉⲥⲃⲩⲧⲉⲣⲟⲥ	5
ⲡ ⲥⲟⲛ ⲉⲧ ⲙⲙⲁⲩ	ⲥⲟⲛ	5
ⲡⲉ ⲑⲃⲃⲓⲟ ⲛ ϩⲏⲧ	ⲑⲃⲃⲓⲟ	5
ⲡ ⲙⲁ	ⲙⲁ	5
ⲡ ⲣⲏ	ⲣⲏ	5
ⲧ ⲙⲉ	ⲙⲉ	5
ⲡ ⲕⲟⲥⲙⲟⲥ ⲧⲏⲣ ϥ	ⲕⲟⲥⲙⲟⲥ	5
ⲡ ⲡⲉⲧϩⲟⲟⲩ	ⲡⲉⲧϩⲟⲟⲩ	5
ⲧⲁ ⲙⲁⲁⲩ	ⲙⲁⲁⲩ	4
ⲧⲁ ⲯⲩⲭⲏ	ⲯⲩⲭⲏ	4
ⲣⲱ ⲕ	ⲣⲱ	4
ⲟⲩ ⲛⲟⲩⲃ	ⲛⲟⲩⲃ	4
ⲟⲩ ⲟⲣⲅⲏ	ⲟⲣⲅⲏ	4
ⲧⲟⲟⲧ ⲟⲩ	ⲧⲟⲟⲧ	4
ⲧ ⲅⲉϩⲉⲛⲛⲁ	ⲅⲉϩⲉⲛⲛⲁ	4
ⲟⲩⲟⲛ	ⲟⲩⲟⲛ	4
ⲥⲁⲣⲝ	ⲥⲁⲣⲝ	4
ⲟⲩ ϩⲁⲧ	ϩⲁⲧ	4
ⲟⲩ ⲡⲛⲉⲩⲙⲁ ⲛ ⲁⲕⲁⲑⲁⲣⲧⲟⲛ	ⲡⲛⲉⲩⲙⲁ	4
ⲡ ⲉⲟⲟⲩ	ⲉⲟⲟⲩ	4
ⲡⲟⲩ ϩⲏⲧ	ϩⲏⲧ	4
ⲛⲉϥ ⲟⲩⲣⲏⲏⲧⲉ	ⲟⲩⲣⲏⲏⲧⲉ	4
ⲡ ⲉⲩⲁⲅⲅⲉⲗⲓⲟⲛ	ⲉⲩⲁⲅⲅⲉⲗⲓⲟⲛ	4
ⲡ ⲙⲛⲧⲥⲛⲟⲟⲩⲥ	ⲙⲛⲧⲥⲛⲟⲟⲩⲥ	4
ⲡ ⲡⲁⲗⲗⲁϯⲟⲛ	ⲡⲁⲗⲗⲁϯⲟⲛ	4
ⲡⲁ ⲙⲉⲣⲓⲧ ϩⲙ ⲡ ϫⲟⲉⲓⲥ	ⲙⲉⲣⲓⲧ	4
ϣⲟⲙⲛⲧ ⲛ ϩⲟⲟⲩ	ϩⲟⲟⲩ	4
ⲛⲉ ⲭⲣⲏⲙⲁ	ⲭⲣⲏⲙⲁ	4
ⲡⲉⲓ ϫⲁⲓⲉ	ϫⲁⲓⲉ	4
ⲡⲉ ⲭⲣⲓⲥⲧⲟⲥ ⲓⲏⲥⲟⲩⲥ	ⲓⲏⲥⲟⲩⲥ	4
ⲛ ⲉⲧ ⲙⲟⲟⲩⲧ	ⲛ	4
ⲧⲟⲟⲧ ϥ	ⲧⲟⲟⲧ	4
ⲛⲉϥ ⲉⲓⲟⲧⲉ	ⲉⲓⲟⲧⲉ	4
ⲡ ⲉⲧ ⲙⲙⲁⲩ	ⲡ	4
ⲛⲉⲛ ⲉⲓⲟⲧⲉ	ⲉⲓⲟⲧⲉ	4
ⲡⲓ ⲟⲩⲟⲉⲓϣ	ⲟⲩⲟⲉⲓϣ	4
ⲡ ⲉⲛⲧ ⲁ ϥ ⲙⲟⲩ	ⲡ	4
ⲁⲃⲣⲁϩⲁⲙ	ⲁⲃⲣⲁϩⲁⲙ	4
ⲱⲛϩ	ⲱⲛϩ	4
ⲡⲁ ⲟⲩⲱϣ	ⲟⲩⲱϣ	4
ⲛ ϣⲏⲣⲉ	ϣⲏⲣⲉ	4
ⲛⲁⲩ ⲛⲓⲙ	ⲛⲁⲩ	4
ⲛⲁ ⲡⲉ ⲭⲣⲓⲥⲧⲟⲥ	ⲛⲁ	4
ⲡⲉ ⲡⲛⲉⲩⲙⲁ ⲛ ⲁⲕⲁⲑⲁⲣⲧⲟⲛ	ⲡⲛⲉⲩⲙⲁ	4
ⲛⲉϥ ϭⲓϫ	ϭⲓϫ	4
ⲡ ⲉⲧ ⲥⲏϭ	ⲡ	4
ⲙⲁⲁϫⲉ	ⲙⲁⲁϫⲉ	4
ⲡⲁ ϩⲏⲡⲁⲣ	ϩⲏⲡⲁⲣ	4
ⲙⲉⲉⲣⲉ	ⲙⲉⲉⲣⲉ	4
ⲙⲛⲧⲣⲉ	ⲙⲛⲧⲣⲉ	4
ⲁⲃⲓⲙⲉⲗⲉⲭ	ⲁⲃⲓⲙⲉⲗⲉⲭ	4
ⲡⲁⲙⲃⲱ	ⲡⲁⲙⲃⲱ	4
ⲟⲩ ϣⲁϫⲉ	ϣⲁϫⲉ	4
ⲡⲁ ⲙⲉⲣⲓⲧ ⲛ ⲉⲓⲱⲧ	ⲙⲉⲣⲓⲧ	4
ⲣⲟⲩϩⲉ	ⲣⲟⲩϩⲉ	4
ⲡⲉ ⲡⲛⲉⲩⲙⲁ ⲙ ⲡ ⲛⲟⲩⲧⲉ	ⲡⲛⲉⲩⲙⲁ	4
ⲡ ⲥⲁϩ	ⲥⲁϩ	4
ⲡ ⲟⲟⲩ	ⲟⲟⲩ	4
ⲡ ⲧⲏⲩ	ⲧⲏⲩ	4
ⲧⲉⲥ ⲙⲁⲁⲩ	ⲙⲁⲁⲩ	4
ⲙⲁⲁⲗⲱⲛ	ⲙⲁⲁⲗⲱⲛ	4
ϣⲁϫⲉ	ϣⲁϫⲉ	4
ϩⲟⲟⲩ	ϩⲟⲟⲩ	4
ⲡ ϫⲁⲓⲉ	ϫⲁⲓⲉ	4
ⲡ ϫⲟⲉⲓⲥ ⲡ ⲛⲟⲩⲧⲉ	ϫⲟⲉⲓⲥ	4
ⲟⲩ ⲙⲛⲧⲥⲟϭ	ⲙⲛⲧⲥⲟϭ	4
ⲧ ϩⲏ	ϩⲏ	4
ⲩ ⲥⲁ	ⲥⲁ	4
ⲇⲁⲩⲉⲓⲇ	ⲇⲁⲩⲉⲓⲇ	4
ϫⲓⲟⲩⲉ	ϫⲓⲟⲩⲉ	3
ⲧ ⲡⲁϣⲉ ⲛ ⲧⲉ ⲩϣⲏ	ⲡⲁϣⲉ	3
ⲛ ⲣⲉϥⲧⲱⲣⲡ	ⲣⲉϥⲧⲱⲣⲡ	3
ⲡ ⲟⲩⲟⲉⲓⲛ ⲙ ⲡⲉ ϩⲟⲟⲩ	ⲟⲩⲟⲉⲓⲛ	3
ⲧⲉⲥ ϣⲉⲗⲉⲉⲧ ⲥⲛⲧⲉ	ϣⲉⲗⲉⲉⲧ	3
ⲧ ⲉⲛⲧⲟⲗⲏ	ⲉⲛⲧⲟⲗⲏ	3
ⲟⲩ ⲕⲟⲩⲓ	ⲕⲟⲩⲓ	3
ⲡⲟⲩ ⲉⲓⲱⲧ	ⲉⲓⲱⲧ	3
ⲧⲉⲓ ⲙⲓⲛⲉ	ⲙⲓⲛⲉ	3
ⲛⲁ ϭⲓϫ	ϭⲓϫ	3
ⲡⲉ ⲡⲛⲉⲩⲙⲁ ⲉⲧ ⲟⲩⲁⲁⲃ	ⲡⲛⲉⲩⲙⲁ	3
ⲧ ⲡⲟⲗⲓⲥ ⲧⲏⲣ ⲥ	ⲡⲟⲗⲓⲥ	3
ⲟⲩ ⲉⲓⲣⲏⲛⲏ ⲛⲧⲉ ⲡ ⲛⲟⲩⲧⲉ	ⲉⲓⲣⲏⲛⲏ	3
ⲟⲩϣⲏ ⲛ ⲣⲟⲉⲓⲥ	ⲟⲩϣⲏ	3
ⲡⲁ ϩⲟ	ϩⲟ	3
ⲉⲃⲟⲧ	ⲉⲃⲟⲧ	3
ⲏⲥⲁⲩ	ⲏⲥⲁⲩ	3
ⲗⲁⲕⲙ	ⲗⲁⲕⲙ	3
ⲛⲟⲃⲉ	ⲛⲟⲃⲉ	3
ⲥⲛⲟϥ	ⲥⲛⲟϥ	3
ⲡⲉⲩ ⲟⲉⲓⲕ	ⲟⲉⲓⲕ	3
ⲛⲁⲓ ⲧⲏⲣ ⲟⲩ	ⲛⲁⲓ	3
ⲟⲩ ϩⲱⲡ	ϩⲱⲡ	3
ⲛⲁ ϣⲉⲉⲣⲉ	ϣⲉⲉⲣⲉ	3
ⲛⲁ ⲛⲟⲃⲉ	ⲛⲟⲃⲉ	3
ⲡ ⲉⲓⲱⲧ	ⲉⲓⲱⲧ	3
ⲡ ⲙⲟⲟⲩ	ⲙⲟⲟⲩ	3
ⲡ ⲥⲁ ⲛ ⲃⲟⲗ	ⲥⲁ	3
ⲡ ⲉⲧ ϩⲟⲟⲩ	ⲡ	3
ⲡ ⲣⲁⲛ ⲙ ⲡ ⲉⲛⲧ ⲁ ϥ ⲙⲟⲩ	ⲣⲁⲛ	3
ⲛ ϣⲟⲛⲧⲉ	ϣⲟⲛⲧⲉ	3
ⲛ ⲉⲧ ⲱϩⲥ	ⲛ	3
ⲡ ⲁⲣⲭⲓⲥⲩⲛⲁⲅⲱⲅⲟⲥ	ⲁⲣⲭⲓⲥⲩⲛⲁⲅⲱⲅⲟⲥ	3
ⲛ ⲁⲅⲁⲑⲟⲛ	ⲁⲅⲁⲑⲟⲛ	3
ⲡⲉⲛ ⲉⲓⲱⲧ	ⲉⲓⲱⲧ	3
ⲡⲉ ⲥⲛⲟϥ	ⲥⲛⲟϥ	3
ⲛⲉⲓ ⲕⲟⲟⲩⲉ	ⲕⲟⲟⲩⲉ	3
ϩⲁϩ ⲛ ϩⲓⲥⲉ	ϩⲓⲥⲉ	3
ⲧ ϣⲉⲗⲉⲉⲧ	ϣⲉⲗⲉⲉⲧ	3
ⲡ ϫⲁⲓⲉ ⲛ ⲁⲧⲙⲟⲟⲩ	ϫⲁⲓⲉ	3
ⲡ ⲣⲁⲛ ⲙ ⲡⲉⲛ ϫⲟⲉⲓⲥ ⲓⲏⲥⲟⲩⲥ ⲡⲉ ⲭⲣⲓⲥⲧⲟⲥ	ⲣⲁⲛ	3
ⲛⲉⲕ ⲙⲁⲑⲏⲧⲏⲥ	ⲙⲁⲑⲏⲧⲏⲥ	3
ⲡ ⲕⲁⲣⲱϥ	ⲕⲁⲣⲱϥ	3
ⲧ ⲉⲕⲕⲗⲏⲥⲓⲁ ⲛ ϣⲓⲏⲧ	ⲉⲕⲕⲗⲏⲥⲓⲁ	3
ⲛ ⲁⲡⲟⲥⲧⲟⲗⲟⲥ	ⲁⲡⲟⲥⲧⲟⲗⲟⲥ	3
ⲧⲉⲩ ϩⲩⲡⲟⲙⲟⲛⲏ	ϩⲩⲡⲟⲙⲟⲛⲏ	3
ⲧ ⲉⲕⲕⲗⲏⲥⲓⲁ · ⲛ ϣⲓⲏⲧ	ⲉⲕⲕⲗⲏⲥⲓⲁ	3
ⲧ ⲁⲛⲟⲙⲓⲁ	ⲁⲛⲟⲙⲓⲁ	3
ⲡ ⲇⲁⲓⲙⲱⲛⲓⲟⲛ	ⲇⲁⲓⲙⲱⲛⲓⲟⲛ	3
ⲡ ⲛⲟⲙⲟⲥ	ⲛⲟⲙⲟⲥ	3
ⲡⲁ ⲙⲉⲉⲩⲉ	ⲙⲉⲉⲩⲉ	3
ⲡⲁ ⲧ ϣⲉⲗⲉⲉⲧ	ⲡⲁ	3
ⲡ ⲛⲁⲩ ⲛ ⲣⲟⲩϩⲉ	ⲛⲁⲩ	3
ⲟⲩⲟⲉⲓϣ	ⲟⲩⲟⲉⲓϣ	3
ⲟⲩⲟⲉⲓⲛ	ⲟⲩⲟⲉⲓⲛ	3
ⲡⲁ ⲛⲟⲩⲧⲉ	ⲛⲟⲩⲧⲉ	3
ⲛ ⲉⲧ ⲛⲙⲙⲁ ϥ	ⲛ	3
ⲇⲓⲟⲕⲗⲏϯⲁⲛⲟⲥ ⲡ ⲣⲣⲟ	ⲇⲓⲟⲕⲗⲏϯⲁⲛⲟⲥ	3
ⲡⲉ ⲙⲧⲟ ⲉⲃⲟⲗ ⲙ ⲡ ⲛⲟⲩⲧⲉ	ⲙⲧⲟ	3
ⲡⲁ ϫⲟⲉⲓⲥ ⲓⲏⲥⲟⲩⲥ ⲡⲉ ⲭⲣⲓⲥⲧⲟⲥ	ⲓⲏⲥⲟⲩⲥ	3
ⲧ ϩⲁⲗⲁⲥⲥⲁ	ϩⲁⲗⲁⲥⲥⲁ	3
ⲡ ⲉⲧ ϩⲏⲛ ⲉϩⲟⲩⲛ ⲉ ⲡ ⲅⲉⲛⲟⲥ	ⲡ	3
ⲥⲙⲟⲧ ⲛⲓⲙ	ⲥⲙⲟⲧ	3
ⲟⲩ ⲙⲏⲏϣⲉ	ⲙⲏⲏϣⲉ	3
ⲧ ⲥⲁⲣⲝ	ⲥⲁⲣⲝ	3
ⲧ ⲥⲁⲧⲉ	ⲥⲁⲧⲉ	3
ⲡ ⲉⲛⲧ ⲁ ⲓ ⲁⲁ ϥ	ⲡ	3
ⲟⲩ ⲛⲟⲩⲧⲉ	ⲛⲟⲩⲧⲉ	3
ⲡ ϫⲓⲛϭⲟⲛⲥ	ϫⲓⲛϭⲟⲛⲥ	3
ⲛⲉⲩ ⲧⲃⲛⲟⲟⲩⲉ	ⲧⲃⲛⲟⲟⲩⲉ	3
ⲥϩⲓⲙⲉ	ⲥϩⲓⲙⲉ	3
ⲛ ⲇⲁⲓⲙⲱⲛ	ⲇⲁⲓⲙⲱⲛ	3
ⲛⲉϥ ⲙⲁⲁϫⲉ	ⲙⲁⲁϫⲉ	3
ⲡ ⲁⲡⲟⲥⲧⲟⲗⲟⲥ	ⲁⲡⲟⲥⲧⲟⲗⲟⲥ	3
ⲛⲕⲁ ⲛⲓⲙ	ⲛⲕⲁ	3
ⲥⲉ	ⲥⲉ	3
ϩⲉⲛ ⲡⲁⲣⲁⲃⲟⲗⲏ	ⲡⲁⲣⲁⲃⲟⲗⲏ	3
ϩⲁϩ	ϩⲁϩ	3
ϩⲁⲧ	ϩⲁⲧ	3
ϩⲱⲃ	ϩⲱⲃ	3
ⲡ ⲕⲁⲛⲱⲛ ⲛ ⲛⲉ ⲥⲛⲏⲩ ⲙ ⲙⲟⲛⲁⲭⲟⲥ	ⲕⲁⲛⲱⲛ	3
ⲧⲟⲩ ⲙⲁⲁⲩ	ⲙⲁⲁⲩ	3
ⲡⲉϥ ⲙⲁ	ⲙⲁ	3
ϩⲱⲃ ⲛ ϭⲓϫ	ϩⲱⲃ	3
ⲡⲉⲕ ⲣⲁⲛ	ⲣⲁⲛ	3
ⲁⲡⲁ	ⲁⲡⲁ	3
ⲏⲣⲡ	ⲏⲣⲡ	3
ⲥⲟⲛ	ⲥⲟⲛ	3
ⲧⲉϥ ⲁⲡⲉ	ⲁⲡⲉ	3
ⲛ ⲣⲉϥⲣⲛⲟⲃⲉ	ⲣⲉϥⲣⲛⲟⲃⲉ	3
ⲡⲉⲛ ϫⲟⲉⲓⲥ	ϫⲟⲉⲓⲥ	3
ⲛ ϩⲉⲑⲛⲟⲥ	ϩⲉⲑⲛⲟⲥ	3
ⲛ ϣⲙⲙⲟ	ϣⲙⲙⲟ	3
ⲛ ϩⲗⲗⲟ	ϩⲗⲗⲟ	3
ϣⲟⲙⲛⲧ ⲛ ⲥⲟⲡ	ⲥⲟⲡ	3
ⲓⲱⲃⲏⲇ	ⲓⲱⲃⲏⲇ	3
ⲡⲉϥ ⲃⲉⲕⲉ	ⲃⲉⲕⲉ	3
ⲧ ⲙⲛⲧϣⲙⲙⲟ	ⲙⲛⲧϣⲙⲙⲟ	3
ⲡ ϩⲱⲃ	ϩⲱⲃ	3
ⲡ ⲉⲧ ⲟⲩ ⲛⲁ ⲟⲩⲟⲙ ϥ	ⲡ	3
ⲗⲁⲁⲩ ⲛ ⲥⲙⲟⲧ	ⲗⲁⲁⲩ	3
ⲛ ⲣⲓⲣ	ⲣⲓⲣ	3
ⲛⲉϥ ⲃⲁⲗ	ⲃⲁⲗ	3
ⲛⲉ ⲥⲛⲏⲩ ⲙ ⲙⲟⲛⲁⲭⲟⲥ	ⲥⲛⲏⲩ	3
ⲟⲩ ϣⲏⲣⲉ	ϣⲏⲣⲉ	3
ⲟⲩ ϩⲟⲧⲉ	ϩⲟⲧⲉ	3
ⲡ ⲱϩⲥ	ⲱϩⲥ	3
ⲛⲉϥ ϩⲙϩⲁⲗ	ϩⲙϩⲁⲗ	3
ⲡ ⲁⲏⲣ	ⲁⲏⲣ	3
ⲡ ⲱⲛϩ	ⲱⲛϩ	3
ⲥⲁⲣⲣⲁ	ⲥⲁⲣⲣⲁ	3
ⲥⲓⲇⲱⲛ	ⲥⲓⲇⲱⲛ	3
ⲛⲉⲛ ⲥⲛⲏⲩ	ⲥⲛⲏⲩ	3
ⲡⲉⲧⲛ ⲥⲱⲙⲁ	ⲥⲱⲙⲁ	3
ⲧⲩⲣⲟⲥ	ⲧⲩⲣⲟⲥ	3
ⲁⲡⲁ ⲁⲛⲧⲱⲛⲓⲟⲥ	ⲁⲛⲧⲱⲛⲓⲟⲥ	3
ⲛⲉϥ ⲉⲛⲧⲟⲗⲏ	ⲉⲛⲧⲟⲗⲏ	3
ⲛⲉ ⲙϩⲁⲟⲩ	ⲙϩⲁⲟⲩ	3
ⲧⲉϥ ϣⲧⲏⲛ	ϣⲧⲏⲛ	3
ⲧⲉ ⲥϩⲓⲙⲉ	ⲥϩⲓⲙⲉ	3
ⲛ ⲉϣⲁⲩ	ⲉϣⲁⲩ	3
ⲡ ϫⲱϩⲙ	ϫⲱϩⲙ	3
ⲕⲉ ϩⲁⲓ	ϩⲁⲓ	3
ⲡⲉ ϣⲧⲉⲕⲟ	ϣⲧⲉⲕⲟ	3
ⲛ ⲁⲅⲅⲉⲗⲟⲥ	ⲁⲅⲅⲉⲗⲟⲥ	3
ⲩ ϩⲟⲟⲩⲧ	ϩⲟⲟⲩⲧ	3
ⲧ ⲉⲛⲧⲟⲗⲏ ⲙ ⲡ ⲛⲟⲩⲧⲉ	ⲉⲛⲧⲟⲗⲏ	3
ⲡ ⲕⲁϩ ⲛ ⲓⲟⲩⲇⲁ	ⲓⲟⲩⲇⲁ	3
ⲩ ⲙⲁ ⲛ ϫⲁⲓⲉ	ⲙⲁ	3
ⲛ ⲁⲓⲱⲛ	ⲁⲓⲱⲛ	3
ⲟⲩ ⲡⲁⲣⲣⲏⲥⲓⲁ	ⲡⲁⲣⲣⲏⲥⲓⲁ	3
ϩⲙϩⲁⲗ	ϩⲙϩⲁⲗ	3
ⲗⲁⲁⲩ ⲛ ϩⲱⲃ	ⲗⲁⲁⲩ	3
ⲧ ϩⲓⲉⲣⲟⲥⲟⲗⲩⲙⲁ	ϩⲓⲉⲣⲟⲥⲟⲗⲩⲙⲁ	3
ⲕⲉ ⲟⲩⲁ	ⲟⲩⲁ	3
ⲡ ⲉⲧ ⲛⲁⲛⲟⲩ ϥ	ⲡ	3
ⲡ ⲉⲧ ϩⲓⲧⲟⲩⲱ ϥ	ⲡ	3
ⲡ ⲉⲧ ϩⲓⲧⲟⲩⲱ ⲛ	ⲡ	3
ⲛ ⲥⲟⲫⲟⲥ	ⲥⲟⲫⲟⲥ	3
ϩⲉⲛ ⲥⲛⲏⲩ	ⲥⲛⲏⲩ	3
ⲧ ⲉⲓⲣⲏⲛⲏ	ⲉⲓⲣⲏⲛⲏ	3
ⲧ ⲉⲕⲕⲗⲏⲥⲓⲁ	ⲉⲕⲕⲗⲏⲥⲓⲁ	3
ⲇⲓⲟⲕⲗⲏϯⲁⲛⲟⲥ ⲇⲉ ⲡ ⲣⲣⲟ	ⲇⲓⲟⲕⲗⲏϯⲁⲛⲟⲥ	2
ϩⲟⲟⲩⲧ	ϩⲟⲟⲩⲧ	2
ⲙ ⲙⲁⲓⲧⲟⲉ ⲛ ϩⲟⲩⲟ	ⲙⲁⲓⲧⲟⲉ	2
ⲡⲉⲧⲛ ϩⲏⲧ	ϩⲏⲧ	2
ⲡ ⲙⲟⲛⲁⲭⲟⲥ	ⲙⲟⲛⲁⲭⲟⲥ	2
ⲡ ϩⲙϩⲁⲗ ⲙ ⲡ ⲛⲟⲩⲧⲉ	ϩⲙϩⲁⲗ	2
ⲟⲩ ⲣⲱⲙⲉ ⲛ ⲇⲓⲕⲁⲓⲟⲥ	ⲣⲱⲙⲉ	2
ⲟⲩ ⲁϣⲁϩⲟⲙ	ⲁϣⲁϩⲟⲙ	2
ⲃⲁⲥⲓⲗⲉⲓⲧⲏⲥ	ⲃⲁⲥⲓⲗⲉⲓⲧⲏⲥ	2
ⲕⲉ ⲩⲁ	ⲩⲁ	2
ϩⲉⲛ ϣⲏⲣⲉ ϣⲏⲙ	ϣⲏⲣⲉ	2
ⲟⲩ ⲁⲥⲟⲩ	ⲁⲥⲟⲩ	2
ϩⲏⲣⲱⲇⲓⲁⲥ	ϩⲏⲣⲱⲇⲓⲁⲥ	2
ⲡ ⲣⲟ ⲙ ⲡ ⲕⲁⲧⲁⲅⲉⲓⲟⲛ	ⲣⲟ	2
ⲟⲩ ⲗⲟⲟⲩ	ⲗⲟⲟⲩ	2
ⲟⲩ ⲣⲁϣⲉ	ⲣⲁϣⲉ	2
ⲟⲩ ⲙⲟⲟⲩ	ⲙⲟⲟⲩ	2
ⲓⲁⲕⲱⲃⲟⲥ ⲡ ϣⲏⲣⲉ ⲛ ⲍⲉⲃⲉⲇⲁⲓⲟⲥ	ⲓⲁⲕⲱⲃⲟⲥ	2
ⲧⲉⲓ ⲃⲛⲛⲉ	ⲃⲛⲛⲉ	2
ϩⲉⲛ ⲙⲛⲧⲥⲟϭ	ⲙⲛⲧⲥⲟϭ	2
ⲧⲉⲩ ⲡⲓⲥⲧⲓⲥ	ⲡⲓⲥⲧⲓⲥ	2
ⲡⲟⲩ ⲗⲁⲟⲥ	ⲗⲁⲟⲥ	2
ⲧⲉⲓ ⲟⲩϣⲏ	ⲟⲩϣⲏ	2
ⲡ ϫⲟⲉⲓⲥ ⲓⲏⲥⲟⲩⲥ	ⲓⲏⲥⲟⲩⲥ	2
ⲡⲉⲧⲛ ⲙⲁ	ⲙⲁ	2
ϩⲉⲛ ⲙⲁ ⲛ ⲕⲁⲕⲉ	ⲙⲁ	2
ⲙ ⲙⲏⲏϣⲉ	ⲙⲏⲏϣⲉ	2
ⲥⲟⲫⲓⲁ ⲛ ⲣⲱⲙⲉ	ⲥⲟⲫⲓⲁ	2
ⲧⲉⲩ ϭⲟⲙ	ϭⲟⲙ	2
ⲡⲉϥ ϩⲱⲃ	ϩⲱⲃ	2
ⲣⲙⲛⲥⲁⲣⲝ	ⲣⲙⲛⲥⲁⲣⲝ	2
ⲟⲛⲟⲣⲓⲟⲥ	ⲟⲛⲟⲣⲓⲟⲥ	2
ⲧ ⲡⲓⲥⲧⲓⲥ	ⲡⲓⲥⲧⲓⲥ	2
ⲟⲩ ⲏⲓ	ⲏⲓ	2
ⲟⲩ ⲛⲁ	ⲛⲁ	2
ⲡⲁ ϥⲱ	ϥⲱ	2
ϩⲣⲱⲙⲁⲛⲟⲥ	ϩⲣⲱⲙⲁⲛⲟⲥ	2
ⲛⲉⲛ ϭⲓϫ	ϭⲓϫ	2
ⲁⲣⲁⲙ	ⲁⲣⲁⲙ	2
ⲡⲉ ⲕⲣⲟ ⲛ ⲧⲉ ⲑⲁⲗⲁⲥⲥⲁ	ⲕⲣⲟ	2
ⲉⲓⲱⲧ	ⲉⲓⲱⲧ	2
ⲙⲁⲁⲃ	ⲙⲁⲁⲃ	2
ⲥⲁϣϥ	ⲥⲁϣϥ	2
ⲟⲣⲫⲁ	ⲟⲣⲫⲁ	2
ⲟⲩⲉⲓ	ⲟⲩⲉⲓ	2
ⲟⲩⲟⲡ	ⲟⲩⲟⲡ	2
ⲥⲁⲧⲉ	ⲥⲁⲧⲉ	2
ⲡⲁ ϩⲱⲃ ⲛ ϭⲓϫ	ϩⲱⲃ	2
ⲧⲉⲓ ϣⲉⲉⲣⲉ ϣⲏⲙ	ϣⲉⲉⲣⲉ	2
ⲉⲛⲉϩ ⲛ ⲉⲛⲉϩ	ⲉⲛⲉϩ	2
ⲧ ⲁⲡⲉ ⲛ ⲓⲱϩⲁⲛⲛⲏⲥ ⲡ ⲃⲁⲡⲧⲓⲥⲧⲏⲥ	ⲁⲡⲉ	2
ⲡⲟⲛⲏⲣⲓⲁ	ⲡⲟⲛⲏⲣⲓⲁ	2
ⲡ ⲕⲁϩ ⲉⲧ ⲛⲁⲛⲟⲩ ϥ	ⲕⲁϩ	2
ⲣⲱ ⲟⲩ	ⲣⲱ	2
ⲭⲁⲣⲓⲥⲙⲁ	ⲭⲁⲣⲓⲥⲙⲁ	2
ⲡⲉ ϩⲟⲟⲩ ⲙ ⲡⲉⲛ ϫⲟⲉⲓⲥ ⲓⲏⲥⲟⲩⲥ ⲡⲉ ⲭⲣⲓⲥⲧⲟⲥ	ϩⲟⲟⲩ	2
ⲡⲉϥ ⲗⲁⲥ	ⲗⲁⲥ	2
ⲛ ⲇⲁⲓⲙⲱⲛⲓⲟⲛ	ⲇⲁⲓⲙⲱⲛⲓⲟⲛ	2
ⲡ ⲇⲓⲁⲧⲁⲅⲙⲁ	ⲇⲓⲁⲧⲁⲅⲙⲁ	2
ⲡⲉϥ ⲑⲃⲃⲓⲟ	ⲑⲃⲃⲓⲟ	2
ⲛ ⲧⲉⲗⲱⲛⲏⲥ	ⲧⲉⲗⲱⲛⲏⲥ	2
ⲕⲟⲥⲙⲟⲥ	ⲕⲟⲥⲙⲟⲥ	2
ⲣⲁⲧ ⲟⲩ	ⲣⲁⲧ	2
ⲧ ⲓⲟⲩⲇⲁⲓⲁ	ⲓⲟⲩⲇⲁⲓⲁ	2
ⲡ ⲙⲓϣⲉ	ⲙⲓϣⲉ	2
ⲡ ⲓⲉⲣⲟ	ⲓⲉⲣⲟ	2
ⲡ ⲗⲁⲟⲥ	ⲗⲁⲟⲥ	2
ⲡ ⲟⲉⲓⲕ	ⲟⲉⲓⲕ	2
ⲡ ⲟⲩⲱϣ	ⲟⲩⲱϣ	2
ⲡⲁⲙⲃⲱ ⲡⲉⲓ ⲉⲗⲁⲭⲓⲥⲧⲟⲥ	ⲡⲁⲙⲃⲱ	2
ϣⲁϫⲉ ⲛⲓⲙ	ϣⲁϫⲉ	2
ⲡ ⲥⲱⲛⲧ	ⲥⲱⲛⲧ	2
ϩⲱⲃ ⲛⲓⲙ ⲙ ⲡⲟⲛⲏⲣⲟⲛ	ϩⲱⲃ	2
ⲛⲉϥ ⲥⲛⲏⲩ	ⲥⲛⲏⲩ	2
ϩⲁϩ ⲛ ⲕⲁϩ	ⲕⲁϩ	2
ϭⲓⲛⲟⲩⲱⲙ	ϭⲓⲛⲟⲩⲱⲙ	2
ⲛ ⲉⲧ ⲟⲛϩ	ⲛ	2
ⲑⲏⲃⲁⲓⲥ	ⲑⲏⲃⲁⲓⲥ	2
ⲛⲉⲛ ⲃⲁⲗ	ⲃⲁⲗ	2
ⲛⲉ ⲧⲙⲉ	ⲧⲙⲉ	2
ⲁⲙⲓⲛⲁⲇⲁⲃ	ⲁⲙⲓⲛⲁⲇⲁⲃ	2
ⲧⲉϥ ⲙⲛⲧⲣⲣⲟ	ⲙⲛⲧⲣⲣⲟ	2
ϩⲱⲃ ⲛⲓⲙ ⲉ ϥ ϩⲟⲟⲩ	ϩⲱⲃ	2
ⲡ ⲟⲩⲁ ⲇⲉ ⲡ ⲟⲩⲁ	ⲟⲩⲁ	2
ⲡ ⲕⲉ ⲥⲉⲉⲡⲉ	ⲥⲉⲉⲡⲉ	2
ⲛⲉⲕ ϫⲁϫⲉ	ϫⲁϫⲉ	2
ⲡⲉϥ ⲙⲉⲉⲩⲉ	ⲙⲉⲉⲩⲉ	2
ⲧⲟⲩ ϣⲱⲙⲉ	ϣⲱⲙⲉ	2
ⲟⲩ ⲑⲗⲓⲯⲓⲥ	ⲑⲗⲓⲯⲓⲥ	2
ⲛⲁ ϩⲟⲉⲓⲧⲉ	ϩⲟⲉⲓⲧⲉ	2
ⲟⲩ ϣⲏⲣⲉ ϣⲏⲙ	ϣⲏⲣⲉ	2
ⲉⲓⲁⲧ ⲟⲩ	ⲉⲓⲁⲧ	2
ⲃⲓⲃⲣⲟⲥ	ⲃⲓⲃⲣⲟⲥ	2
ⲟⲩ ⲛⲟϭ	ⲛⲟϭ	2
ⲟⲩ ⲣⲁⲛ	ⲣⲁⲛ	2
ⲡⲉⲛ ⲃⲓⲟⲥ	ⲃⲓⲟⲥ	2
ⲡⲉⲛ ⲙⲓϣⲉ	ⲙⲓϣⲉ	2
ⲡⲉⲛ ⲥⲱⲙⲁ	ⲥⲱⲙⲁ	2
ⲕⲁⲫⲁⲣⲛⲁⲟⲩⲙ	ⲕⲁⲫⲁⲣⲛⲁⲟⲩⲙ	2
ⲡⲁⲣⲁⲃⲟⲗⲏ	ⲡⲁⲣⲁⲃⲟⲗⲏ	2
ⲛ ⲉⲧ ⲟⲩ ϫⲓ ⲙⲙⲟ ⲟⲩ ⲛ ϭⲟⲛⲥ	ⲛ	2
ⲟⲩ ϭⲟⲙ ⲛⲧⲉ ⲡ ⲛⲟⲩⲧⲉ	ϭⲟⲙ	2
ⲡⲉ ⲥⲛⲁⲩ	ⲥⲛⲁⲩ	2
ⲟⲩ ⲭⲟⲣⲧⲟⲥ	ⲭⲟⲣⲧⲟⲥ	2
ⲧⲉ ⲕⲣⲓⲥⲓⲥ	ⲕⲣⲓⲥⲓⲥ	2
ⲛ ⲉⲛⲧⲟⲗⲏ ⲙ ⲡ ⲛⲟⲩⲧⲉ	ⲉⲛⲧⲟⲗⲏ	2
ⲡⲟⲩ ⲣⲁⲛ	ⲣⲁⲛ	2
ⲡ ⲑⲃⲃⲓⲟ	ⲑⲃⲃⲓⲟ	2
ⲡⲁ ϣⲁϫⲉ	ϣⲁϫⲉ	2
ⲧ ⲡⲁⲣⲁⲇⲟⲥⲓⲥ ⲛ ⲛⲉ ⲡⲣⲉⲥⲃⲩⲧⲉⲣⲟⲥ	ⲡⲁⲣⲁⲇⲟⲥⲓⲥ	2
ⲛ ⲁⲅⲅⲉⲗⲟⲥ ⲉⲧ ⲟⲩⲁⲁⲃ	ⲁⲅⲅⲉⲗⲟⲥ	2
ⲟⲩ ⲧⲉⲗⲱⲛⲏⲥ	ⲧⲉⲗⲱⲛⲏⲥ	2
ⲡⲉϥ ⲥⲟⲉⲓⲧ	ⲥⲟⲉⲓⲧ	2
ⲡⲉⲥ ⲗⲁⲟⲥ	ⲗⲁⲟⲥ	2
ⲛⲉⲩ ⲧⲟⲡⲟⲥ	ⲧⲟⲡⲟⲥ	2
ⲟⲩ ⲛⲟϭ ⲛ ϩⲣⲟⲟⲩ	ϩⲣⲟⲟⲩ	2
ⲟⲩ ⲡⲉⲧⲛⲁⲛⲟⲩϥ	ⲡⲉⲧⲛⲁⲛⲟⲩϥ	2
ⲛⲉ ⲥⲧⲣⲁⲧⲏⲗⲁⲧⲏⲥ	ⲥⲧⲣⲁⲧⲏⲗⲁⲧⲏⲥ	2
ⲛ ⲉⲧ ϩⲓϩⲟⲩⲛ	ⲛ	2
ⲛ ⲉⲧ ⲛⲕⲟⲧⲕ	ⲛ	2
ⲛⲉⲩ ϣⲛⲏⲩ	ϣⲛⲏⲩ	2
ⲡⲉϥ ϣⲏⲣⲉ	ϣⲏⲣⲉ	2
ⲧⲟⲟⲧ ⲛ	ⲧⲟⲟⲧ	2
ⲡⲉϥ ϩⲓⲥⲉ	ϩⲓⲥⲉ	2
ⲡⲉϥ ϭⲃⲟⲓ	ϭⲃⲟⲓ	2
ⲡⲉϥ ϭⲱⲛⲧ	ϭⲱⲛⲧ	2
ⲡ ⲓⲟⲣⲇⲁⲛⲏⲥ	ⲓⲟⲣⲇⲁⲛⲏⲥ	2
ⲥⲁⲗⲙⲱⲛ	ⲥⲁⲗⲙⲱⲛ	2
ⲡ ⲉⲧⲉ ⲩⲛⲧ ϥ ⲙⲁⲁϫⲉ ⲙⲙⲁⲩ ⲉ ⲥⲱⲧⲙ	ⲡ	2
ⲙ ⲡⲉⲧϩⲟⲟⲩ	ⲡⲉⲧϩⲟⲟⲩ	2
ⲧ ⲇⲓⲕⲁⲓⲟⲥⲩⲛⲏ	ⲇⲓⲕⲁⲓⲟⲥⲩⲛⲏ	2
ⲟⲩ ⲛ ϩⲱⲃ	ⲟⲩ	2
ⲧ ⲇⲉⲕⲁⲡⲟⲗⲓⲥ	ⲇⲉⲕⲁⲡⲟⲗⲓⲥ	2
ⲡ ⲣⲙⲙⲁⲟ	ⲣⲙⲙⲁⲟ	2
ⲡ ϫⲁⲓⲉ ⲉⲧ ϩⲓϩⲟⲩⲛ	ϫⲁⲓⲉ	2
ⲛ ⲣⲉϥϫⲓ ⲛ ϭⲟⲛⲥ	ⲣⲉϥϫⲓ	2
ϩⲣⲱⲙⲁⲛⲟⲥ ⲡⲉ ⲥⲧⲣⲁⲧⲏⲗⲁⲧⲏⲥ	ϩⲣⲱⲙⲁⲛⲟⲥ	2
ⲡⲉϥ ⲡⲛⲉⲩⲙⲁ	ⲡⲛⲉⲩⲙⲁ	2
ⲛ ⲉⲧ ⲉⲓⲛⲉ ⲙⲙⲟ ⲕ	ⲛ	2
ⲧ ⲕⲱⲙⲏ	ⲕⲱⲙⲏ	2
ⲟⲩ ⲙⲁⲉⲓⲛ	ⲙⲁⲉⲓⲛ	2
ⲡ ⲧⲁⲉⲓⲟ	ⲧⲁⲉⲓⲟ	2
ⲧ ⲟⲩⲉⲓ	ⲟⲩⲉⲓ	2
ⲧ ⲡⲩⲗⲏ	ⲡⲩⲗⲏ	2
ⲡ ⲉⲧ ⲧⲱϭⲉ	ⲡ	2
ⲧ ⲥⲛⲧⲉ	ⲥⲛⲧⲉ	2
ⲟⲩ ⲡⲉⲧϩⲟⲟⲩ	ⲡⲉⲧϩⲟⲟⲩ	2
ⲟⲩ ⲕⲱϩ ⲛ ⲧⲟⲟⲩ	ⲕⲱϩ	2
ⲗⲉⲅⲓⲱⲛ	ⲗⲉⲅⲓⲱⲛ	2
ϩⲣⲉⲃⲉⲕⲕⲁ	ϩⲣⲉⲃⲉⲕⲕⲁ	2
ⲡ ⲧⲣⲉ ϥ ϫⲟⲟ ⲥ	ⲧⲣⲉ	2
ⲡⲉ ⲟⲩⲟⲉⲓϣ ⲉⲧ ⲙⲙⲁⲩ	ⲟⲩⲟⲉⲓϣ	2
ⲁⲧϩⲏⲧ	ⲁⲧϩⲏⲧ	2
ⲛⲉ ϩⲓⲟⲙⲉ	ϩⲓⲟⲙⲉ	2
ⲡ ϩⲟⲟⲩ ⲛ ϩⲟⲟⲩ	ϩⲟⲟⲩ	2
ⲛ ⲉⲧ ϣⲟⲟⲡ	ⲛ	2
ⲛⲉ ϩⲟⲟⲩ ⲉⲧ ⲙⲙⲁⲩ	ϩⲟⲟⲩ	2
ⲡ ⲃⲟⲗ ⲙ ⲡ ⲣⲱⲙⲉ	ⲃⲟⲗ	2
ⲙⲛⲧⲣⲙϩⲉ	ⲙⲛⲧⲣⲙϩⲉ	2
ⲧⲉⲕ ⲁⲣⲭⲏ	ⲁⲣⲭⲏ	2
ⲧⲉⲕ ⲙⲁⲁⲩ	ⲙⲁⲁⲩ	2
ⲙⲁⲁⲃⲧⲏ ⲛ ⲛⲟⲩⲧⲉ	ⲛⲟⲩⲧⲉ	2
ⲇⲓⲟⲕⲗⲏϯⲁⲛⲟⲥ	ⲇⲓⲟⲕⲗⲏϯⲁⲛⲟⲥ	2
ⲏⲣⲡ ⲛ ⲃⲣⲣⲉ	ⲏⲣⲡ	2
ⲛ ⲉⲛⲧ ⲁ ⲥ ⲕⲟⲧϥ ⲟⲩ	ⲛ	2
ⲛⲉ ⲡⲛⲉⲩⲙⲁ ⲛ ⲁⲕⲁⲑⲁⲣⲧⲟⲛ	ⲡⲛⲉⲩⲙⲁ	2
ⲟⲩ ⲉⲓⲣⲏⲛⲏ	ⲉⲓⲣⲏⲛⲏ	2
ⲧⲟⲩ ⲧⲁⲡⲣⲟ	ⲧⲁⲡⲣⲟ	2
ⲧ ⲟⲓⲕⲟⲩⲙⲉⲛⲏ	ⲟⲓⲕⲟⲩⲙⲉⲛⲏ	2
ⲁⲩⲏⲧ ⲁⲩⲏⲧ	ⲁⲩⲏⲧ	2
ϣⲉ	ϣⲉ	2
ϣⲓ	ϣⲓ	2
ⲟⲩ ⲥⲟⲫⲓⲁ	ⲥⲟⲫⲓⲁ	2
ⲙⲁ	ⲙⲁ	2
ⲡⲏ	ⲡⲏ	2
ⲛ ⲉⲥⲟⲟⲩ ⲛ ⲗⲁⲃⲁⲛ	ⲉⲥⲟⲟⲩ	2
ⲛⲉϥ ⲛⲟⲩⲧⲉ	ⲛⲟⲩⲧⲉ	2
ⲟⲩ ⲧⲁⲙⲓⲟ	ⲧⲁⲙⲓⲟ	2
ϩⲁⲉ	ϩⲁⲉ	2
ϯⲥⲟ	ϯⲥⲟ	2
ⲛⲁ ⲡ ⲛⲟⲩⲧⲉ	ⲛⲁ	2
ⲁⲙⲛⲧⲉ	ⲁⲙⲛⲧⲉ	2
ⲛⲉⲥ ϫⲁϫⲉ	ϫⲁϫⲉ	2
ⲡ ⲣⲣⲟ ⲇⲉ ⲇⲓⲟⲕⲗⲏϯⲁⲛⲟⲥ	ⲇⲓⲟⲕⲗⲏϯⲁⲛⲟⲥ	2
ⲙ ⲙⲟⲩⲓ	ⲙⲟⲩⲓ	2
ⲛⲉⲕ ⲛⲟⲃⲉ	ⲛⲟⲃⲉ	2
ⲛ ⲣⲉϥϣⲙϣⲉⲉⲓⲇⲱⲗⲟⲛ	ⲣⲉϥϣⲙϣⲉⲉⲓⲇⲱⲗⲟⲛ	2
ⲟⲩ ⲙⲛⲧⲁⲧϩⲏⲧ	ⲙⲛⲧⲁⲧϩⲏⲧ	2
ⲟⲩ ⲙⲏⲏϣⲉ ⲛ ϩⲟⲟⲩ	ⲙⲏⲏϣⲉ	2
ⲡ ⲙⲧⲟ ⲉⲃⲟⲗ ⲙ ⲡ ϫⲟⲉⲓⲥ	ⲙⲧⲟ	2
ⲧⲁ ϩⲓⲏ	ϩⲓⲏ	2
ⲧⲁ ϭⲟⲙ	ϭⲟⲙ	2
ⲟⲩ ⲥⲟⲟⲩⲧⲛ	ⲥⲟⲟⲩⲧⲛ	2
ⲛ ⲉⲧ ⲟⲩⲁⲁⲃ ⲧⲏⲣ ⲟⲩ	ⲛ	2
ⲣⲱⲙⲉ ⲛⲓⲙ	ⲣⲱⲙⲉ	2
ⲁⲛⲇⲣⲉⲁⲥ	ⲁⲛⲇⲣⲉⲁⲥ	2
ⲛⲉϥ ϣⲉⲉⲣⲉ ϣⲏⲙ	ϣⲉⲉⲣⲉ	2
ⲧⲉϥ ⲕⲗⲏⲣⲟⲛⲟⲙⲓⲁ	ⲕⲗⲏⲣⲟⲛⲟⲙⲓⲁ	2
ⲡⲉϥ ϩⲟ	ϩⲟ	2
ⲃⲏⲑⲗⲉⲉⲙ ⲙ ⲡ ⲕⲁϩ ⲛ ⲓⲟⲩⲇⲁ	ⲃⲏⲑⲗⲉⲉⲙ	2
ⲛⲉⲩ ⲏⲓ	ⲏⲓ	2
ⲡⲉⲓ ⲕⲉⲧ	ⲕⲉⲧ	2
ⲡⲉⲓ ⲕⲣⲟ	ⲕⲣⲟ	2
ⲉⲥⲣⲱⲙ	ⲉⲥⲣⲱⲙ	2
ⲡ ⲙⲕⲁϩ ⲛ ϩⲏⲧ	ⲙⲕⲁϩ	2
ⲡⲉⲧⲛⲁⲛⲟⲩϥ ⲛⲓⲙ	ⲡⲉⲧⲛⲁⲛⲟⲩϥ	2
ⲟⲩ ⲙⲁ ⲛ ϣⲱⲡⲉ	ⲙⲁ	2
ⲡⲉⲛ ⲡⲉⲧⲛⲁⲛⲟⲩϥ	ⲡⲉⲧⲛⲁⲛⲟⲩϥ	2
ⲧ ⲕⲁⲧⲁⲃⲟⲗⲏ ⲙ ⲡ ⲕⲟⲥⲙⲟⲥ	ⲕⲁⲧⲁⲃⲟⲗⲏ	2
ⲓⲉⲥⲥⲁⲓ	ⲓⲉⲥⲥⲁⲓ	2
ⲡⲉⲓ ⲗⲁⲟⲥ	ⲗⲁⲟⲥ	2
ⲡ ⲉⲧ ϣϣⲉ	ⲡ	2
ⲛⲉϥ ⲧⲏⲏⲃⲉ	ⲧⲏⲏⲃⲉ	2
ⲃⲁⲗ	ⲃⲁⲗ	2
ⲛⲉϩ	ⲛⲉϩ	2
ⲗⲓⲁ	ⲗⲓⲁ	2
ⲛⲁⲩ	ⲛⲁⲩ	2
ⲧⲉϥ ⲥⲃⲱ	ⲥⲃⲱ	2
ⲧ ⲙⲛⲧⲣⲣⲟ ⲛ ⲙ ⲡⲏⲩⲉ	ⲙⲛⲧⲣⲣⲟ	2
ⲡ ⲉⲧ ϩⲏⲡ	ⲡ	2
ϩⲉⲛ ⲥⲁⲣⲕⲓⲕⲟⲥ	ⲥⲁⲣⲕⲓⲕⲟⲥ	2
ⲧⲉⲓ ⲅⲉⲛⲉⲁ	ⲅⲉⲛⲉⲁ	2
ⲡ ⲉⲧ ⲕ ⲛⲁ ϣⲁⲁ ϥ	ⲡ	2
ⲡⲁ ⲗⲁⲟⲥ	ⲗⲁⲟⲥ	2
ⲡⲉⲕ ⲗⲁⲟⲥ ⲡ ⲓⲥⲣⲁⲏⲗ	ⲓⲥⲣⲁⲏⲗ	2
ⲡⲁ ⲥⲱⲙⲁ	ⲥⲱⲙⲁ	2
ⲡ ⲉⲧ ϫⲟ	ⲡ	2
ⲡⲁ ⲙⲉⲣⲓⲧ ⲛ ⲥⲟⲛ ⲁⲡⲁ ⲡⲁⲙⲃⲱ	ⲡⲁⲙⲃⲱ	2
ⲩ ⲙⲛⲧⲛⲟϭ	ⲙⲛⲧⲛⲟϭ	2
ⲡ ϣⲏⲓ ⲛ ⲙ ⲙⲟⲩⲓ	ϣⲏⲓ	2
ⲡⲉⲥ ϩⲁⲓ	ϩⲁⲓ	2
ⲛⲉⲧⲛ ⲃⲁⲗ	ⲃⲁⲗ	2
ⲡ ⲙⲏⲏϣⲉ ⲧⲏⲣ ϥ	ⲙⲏⲏϣⲉ	2
ⲡⲉⲛ ⲥⲟⲛ	ⲥⲟⲛ	2
ⲡ ⲕⲁⲧⲁⲅⲉⲓⲟⲛ	ⲕⲁⲧⲁⲅⲉⲓⲟⲛ	2
ⲡ ϫⲟⲉⲓⲥ ⲓⲏⲥⲟⲩⲥ ⲡⲉ ⲭⲣⲓⲥⲧⲟⲥ	ⲓⲏⲥⲟⲩⲥ	2
ⲡⲉ ϫⲣⲟ ϩⲙ ⲡ ⲡⲟⲗⲉⲙⲟⲥ	ϫⲣⲟ	2
ⲛ ϩⲙⲥ	ϩⲙⲥ	2
ⲛ ϩⲱⲧ	ϩⲱⲧ	2
ⲛ ϭⲟⲙ	ϭⲟⲙ	2
ⲡ ⲥⲁϣϥ ⲛ ⲟⲉⲓⲕ	ⲟⲉⲓⲕ	2
ⲡⲁϩⲟⲩ ⲛ ⲛ ϫⲁⲓⲟϩⲥ	ⲡⲁϩⲟⲩ	2
ⲕⲁⲕⲓⲁ	ⲕⲁⲕⲓⲁ	2
ϫⲓⲛϭⲟⲛⲥ	ϫⲓⲛϭⲟⲛⲥ	2
ⲡⲉⲕ ⲙⲁ ⲛ ϣⲱⲡⲉ	ⲙⲁ	2
ⲕⲏⲫⲁⲥ	ⲕⲏⲫⲁⲥ	2
ⲡⲉϥ ⲁⲛⲁⲓ	ⲁⲛⲁⲓ	2
ⲡⲉϥ ⲕⲱⲧⲉ	ⲕⲱⲧⲉ	2
ⲡⲉϥ ⲗⲁⲟⲥ	ⲗⲁⲟⲥ	2
ⲡⲉϥ ⲧⲃⲃⲟ	ⲧⲃⲃⲟ	2
ⲧⲉⲩ ⲙⲏⲏⲧⲉ	ⲙⲏⲏⲧⲉ	2
ⲗⲁⲃⲁⲛ	ⲗⲁⲃⲁⲛ	2
ⲡ ⲉⲧ ⲧⲥⲟ	ⲡ	2
ϩⲉⲛ ϩⲏⲃⲥ	ϩⲏⲃⲥ	2
ϩⲉⲛ ϩⲟⲟⲩ	ϩⲟⲟⲩ	2
ⲩ ⲡⲉⲧⲛⲁⲛⲟⲩϥ	ⲡⲉⲧⲛⲁⲛⲟⲩϥ	2
ⲧ ⲙⲛⲧϩⲏⲕⲉ	ⲙⲛⲧϩⲏⲕⲉ	2
ⲛ ⲇⲓⲕⲁⲓⲟⲥ	ⲇⲓⲕⲁⲓⲟⲥ	2
ⲧⲉ ⲡⲣⲱ	ⲡⲣⲱ	2
ⲧⲉ ⲥⲃⲱ	ⲥⲃⲱ	2
ⲙⲉⲣⲟⲥ	ⲙⲉⲣⲟⲥ	2
ⲡ ϣⲱⲙ	ϣⲱⲙ	2
ⲡ ϩⲏⲧ	ϩⲏⲧ	2
ⲟⲩ ⲁⲅⲁⲑⲟⲛ	ⲁⲅⲁⲑⲟⲛ	2
ⲥⲁϩⲟⲩ	ⲥⲁϩⲟⲩ	2
ⲡⲛⲉⲩⲙⲁ	ⲡⲛⲉⲩⲙⲁ	2
ⲡⲉⲕ ϭⲗⲟϭ	ϭⲗⲟϭ	2
ⲧⲉ ⲯⲩⲭⲏ	ⲯⲩⲭⲏ	2
ⲛ ⲉⲧ ⲙⲙⲁⲩ	ⲛ	2
ⲛ ⲉⲧ ⲧⲁϩⲉ	ⲛ	2
ⲫⲓⲗⲓⲡⲡⲟⲥ	ⲫⲓⲗⲓⲡⲡⲟⲥ	2
ⲡⲁ ϫⲟⲉⲓⲥ	ϫⲟⲉⲓⲥ	2
ⲡⲉ ⲩⲟⲉⲓϣ	ⲩⲟⲉⲓϣ	2
ⲧ ⲡⲟⲣⲛⲉⲓⲁ	ⲡⲟⲣⲛⲉⲓⲁ	2
ⲡⲉ ⲟⲩⲟⲉⲓϣ	ⲟⲩⲟⲉⲓϣ	2
ϩⲣⲁ ⲩ	ϩⲣⲁ	2
ⲧⲉϥ ⲥϩⲓⲙⲉ	ⲥϩⲓⲙⲉ	2
ⲧⲉⲛ ⲯⲩⲭⲏ	ⲯⲩⲭⲏ	2
ⲁⲡⲁ ⲡⲁⲙⲃⲱ ⲡⲉ ⲡⲣⲉⲥⲃⲩⲧⲉⲣⲟⲥ ⲛ ⲧ ⲉⲕⲕⲗⲏⲥⲓⲁ ⲛ ϣⲓⲏⲧ	ⲡⲁⲙⲃⲱ	2
ⲡⲟⲣⲛⲟⲥ	ⲡⲟⲣⲛⲟⲥ	2
ⲛ ⲁⲣⲭⲱⲛ	ⲁⲣⲭⲱⲛ	2
ⲛⲉⲧⲛ ϫⲓⲛϭⲟⲛⲥ	ϫⲓⲛϭⲟⲛⲥ	2
ⲓⲟⲩⲇⲁⲓ	ⲓⲟⲩⲇⲁⲓ	2
ⲟⲩ ϣⲥⲛⲉ	ϣⲥⲛⲉ	2
ⲟⲩ ϩⲓⲥⲉ	ϩⲓⲥⲉ	2
ⲟⲩ ϫⲁⲓⲉ	ϫⲁⲓⲉ	2
ⲟⲩ ϭⲱⲛⲧ	ϭⲱⲛⲧ	2
ⲡⲉ ϩⲟⲟⲩ ⲉⲧ ⲙⲙⲁⲩ	ϩⲟⲟⲩ	2
ⲣⲟⲉⲓⲥ	ⲣⲟⲉⲓⲥ	2
ⲣⲟⲙⲡⲉ	ⲣⲟⲙⲡⲉ	2
ⲡ ⲏⲣⲡ	ⲏⲣⲡ	2
ⲡ ⲧⲱϣ	ⲧⲱϣ	2
ⲡ ⲣⲁⲛ	ⲣⲁⲛ	2
ⲡ ⲱⲛⲉ	ⲱⲛⲉ	2
ⲛ ⲉⲡⲁⲣⲭⲟⲥ	ⲉⲡⲁⲣⲭⲟⲥ	2
ⲟⲩ ⲭⲣⲓⲥϯⲁⲛⲟⲥ	ⲭⲣⲓⲥϯⲁⲛⲟⲥ	2
ⲭⲉⲗⲁⲓⲱⲛ	ⲭⲉⲗⲁⲓⲱⲛ	2
ⲧ ⲙⲛⲧⲙⲛⲧⲣⲉ ⲙ ⲡ ⲛⲟⲩⲧⲉ	ⲙⲛⲧⲙⲛⲧⲣⲉ	2
ϩⲉⲛ ⲣⲙⲉⲓⲟⲟⲩⲉ	ⲣⲙⲉⲓⲟⲟⲩⲉ	2
ⲥⲟⲫⲟⲥ	ⲥⲟⲫⲟⲥ	2
ⲟⲩ ϫⲟⲉⲓⲥ	ϫⲟⲉⲓⲥ	2
ⲧⲁⲉⲓⲟ	ⲧⲁⲉⲓⲟ	2
ⲛ ϣⲏⲣⲉ ϣⲏⲙ	ϣⲏⲣⲉ	2
ⲟⲩ ϭⲉⲣⲱⲃ	ϭⲉⲣⲱⲃ	2
ⲧⲉⲓ ⲟⲩⲛⲟⲩ	ⲟⲩⲛⲟⲩ	2
ⲧ ⲙⲛⲧⲙⲁⲓⲣⲱⲙⲉ	ⲙⲛⲧⲙⲁⲓⲣⲱⲙⲉ	2
ⲧ ⲛⲁⲩ	ⲛⲁⲩ	2
ⲡ ⲣⲁⲛ ⲛ ⲓⲏⲥⲟⲩⲥ	ⲣⲁⲛ	2
ⲡⲉⲓ ⲥⲁ	ⲥⲁ	2
ⲙ ⲙⲁⲑⲏⲧⲏⲥ ⲛ ⲓⲱϩⲁⲛⲛⲏⲥ	ⲙⲁⲑⲏⲧⲏⲥ	2
ⲫⲁⲣⲉⲥ	ⲫⲁⲣⲉⲥ	2
ⲡ ⲉⲧ ⲟ ⲛ ⲇⲁⲓⲙⲱⲛⲓⲟⲛ	ⲡ	2
ϩⲉⲛ ϣⲉ	ϣⲉ	2
ⲧⲉⲕ ϩⲙϩⲁⲗ	ϩⲙϩⲁⲗ	2
ⲓⲱϩⲁⲛⲛⲏⲥ ⲡ ⲑⲉⲟⲗⲟⲅⲟⲥ	ⲓⲱϩⲁⲛⲛⲏⲥ	2
ϣⲏⲣⲉ	ϣⲏⲣⲉ	2
ϩⲃⲥⲱ	ϩⲃⲥⲱ	2
ϩⲓⲥⲉ	ϩⲓⲥⲉ	2
ϩⲟⲧⲉ	ϩⲟⲧⲉ	2
ϫⲣⲟⲡ	ϫⲣⲟⲡ	2
ϯⲧⲱⲛ	ϯⲧⲱⲛ	2
ⲡ ⲉⲧ ⲙⲟⲥⲧⲉ	ⲡ	2
ⲡⲉⲕ ⲙⲉⲉⲩⲉ	ⲙⲉⲉⲩⲉ	2
ⲛⲉ ⲭⲏⲣⲁ	ⲭⲏⲣⲁ	2
ⲛⲉϥ ϩⲃⲏⲩⲉ	ϩⲃⲏⲩⲉ	2
ⲭⲣⲏⲙⲁ	ⲭⲣⲏⲙⲁ	2
ⲛⲉ ⲑⲏⲣⲓⲟⲛ	ⲑⲏⲣⲓⲟⲛ	2
ⲡ ϩⲱⲃ ⲙ ⲡ ⲟⲩⲁ ⲡ ⲟⲩⲁ	ϩⲱⲃ	2
ⲡⲉ ϩⲙⲉ ⲛ ϩⲟⲟⲩ	ϩⲟⲟⲩ	2
ⲟⲩ ϩⲉⲑⲛⲓⲕⲟⲥ	ϩⲉⲑⲛⲓⲕⲟⲥ	2
ϯ ⲉⲣⲏⲙⲓⲁ	ⲉⲣⲏⲙⲓⲁ	2
ⲧ ϩⲓⲉⲣⲟⲩⲥⲁⲗⲏⲙ	ϩⲓⲉⲣⲟⲩⲥⲁⲗⲏⲙ	2
ⲡ ⲣⲡⲉ ⲙ ⲡ ⲛⲟⲩⲧⲉ	ⲣⲡⲉ	2
ⲛⲉϥ ⲥⲙⲟⲩ ⲉⲧ ⲟⲩⲁⲁⲃ	ⲥⲙⲟⲩ	2
ⲛ ⲉⲧ ϩⲓⲧⲟⲩⲱ ⲟⲩ	ⲛ	2
ⲧ ⲥⲩⲣⲓⲁ	ⲥⲩⲣⲓⲁ	2
ⲡ ⲟⲩⲱϣ ⲙ ⲡ ⲛⲟⲩⲧⲉ	ⲟⲩⲱϣ	2
ⲟⲩ ⲧⲱⲧ ⲛ ϩⲏⲧ	ⲧⲱⲧ	2
ⲛ ⲉⲧ ϩⲛ ⲧ ⲡⲁϣⲉ ⲛ ⲧⲉ ⲩϣⲏ	ⲛ	2
ⲡ ϯⲧⲱⲛ	ϯⲧⲱⲛ	2
ⲛⲁ ⲙⲉⲉⲩⲉ	ⲙⲉⲉⲩⲉ	2
ⲙ ⲙⲛⲧⲁⲡⲓⲥⲧⲟⲥ	ⲙⲛⲧⲁⲡⲓⲥⲧⲟⲥ	2
ⲟⲩ ⲁⲡⲉⲓⲗⲏ	ⲁⲡⲉⲓⲗⲏ	2
ⲛ ⲥⲁⲃⲉⲉⲩ	ⲥⲁⲃⲉⲉⲩ	2
ⲉⲩϩⲁⲓⲟⲥ	ⲉⲩϩⲁⲓⲟⲥ	2
ⲛⲁⲁⲥⲥⲱⲛ	ⲛⲁⲁⲥⲥⲱⲛ	2
ⲛ ⲉⲧ ϩⲓⲃⲟⲗ	ⲛ	2
ⲛ ⲣⲱⲙⲉ ⲛ ϩⲣⲱⲙⲁⲓⲟⲥ	ⲣⲱⲙⲉ	2
ⲡ ⲡⲟⲗⲉⲙⲟⲥ	ⲡⲟⲗⲉⲙⲟⲥ	2
ⲟⲩ ⲙⲓⲗⲓⲟⲛ	ⲙⲓⲗⲓⲟⲛ	2
ⲓⲱϩⲁⲛⲛⲏⲥ ⲡ ⲃⲁⲡⲧⲓⲥⲧⲏⲥ	ⲓⲱϩⲁⲛⲛⲏⲥ	2
ⲏⲥⲁⲓⲁⲥ	ⲏⲥⲁⲓⲁⲥ	2
ⲙ ⲙⲁⲑⲏⲧⲏⲥ	ⲙⲁⲑⲏⲧⲏⲥ	2
ⲍⲉⲃⲉⲇⲁⲓⲟⲥ	ⲍⲉⲃⲉⲇⲁⲓⲟⲥ	2
ϫⲓⲛϭⲟⲛⲥ ⲛⲓⲙ	ϫⲓⲛϭⲟⲛⲥ	2
ⲛ ⲟⲣⲫⲁⲛⲟⲥ	ⲟⲣⲫⲁⲛⲟⲥ	2
ⲡⲉ ϣⲗⲏⲗ	ϣⲗⲏⲗ	2
ⲛ ⲥⲱϣⲉ	ⲥⲱϣⲉ	2
ⲛ ⲛⲟⲃⲉ	ⲛⲟⲃⲉ	2
ⲁⲗⲫⲁⲓⲟⲥ	ⲁⲗⲫⲁⲓⲟⲥ	2
ⲣⲁⲕⲟⲧⲉ	ⲣⲁⲕⲟⲧⲉ	2
ⲡⲉ ϩⲙⲟⲩ	ϩⲙⲟⲩ	2
ⲡⲉ ϫⲡⲓⲟ	ϫⲡⲓⲟ	2
ⲡⲉ ϭⲗⲟϭ	ϭⲗⲟϭ	2
ⲡ ⲕⲁⲓⲣⲟⲥ	ⲕⲁⲓⲣⲟⲥ	2
ⲧⲉⲕ ϭⲓϫ	ϭⲓϫ	2
ⲁⲧⲥⲱⲧⲙ	ⲁⲧⲥⲱⲧⲙ	2
ⲡⲉϥ ϣⲏⲣⲉ ⲥⲛⲁⲩ	ϣⲏⲣⲉ	2
ⲧ ϩⲉ	ϩⲉ	2
ⲛ ϫⲁⲓⲟϩⲥ	ϫⲁⲓⲟϩⲥ	2
ϩⲉⲛ ⲁⲅⲅⲉⲗⲟⲥ	ⲁⲅⲅⲉⲗⲟⲥ	2
ϩⲉⲛ ⲕⲣⲟϥ	ⲕⲣⲟϥ	2
ϩⲉⲛ ⲙⲁⲥⲉ	ⲙⲁⲥⲉ	2
ⲡ ⲛⲟⲃⲉ ⲉⲛⲧ ⲁ ⲛ ⲙⲉⲉⲩⲉ ⲉ ϣⲁⲁⲧ ϥ ⲉⲃⲟⲗ ⲙⲙⲟ ⲛ ⲉⲧⲃⲏⲏⲧ ϥ	ⲛⲟⲃⲉ	2
ⲡ ⲣⲟⲟⲩϣ ⲙ ⲡ ⲛⲁ	ⲣⲟⲟⲩϣ	2
ⲧⲉⲓ ϩⲙϩⲁⲗ	ϩⲙϩⲁⲗ	2
ⲛ ⲗⲏⲥⲧⲏⲥ	ⲗⲏⲥⲧⲏⲥ	2
ⲡⲉϥ ϩⲩⲡⲟⲇⲏⲙⲁ	ϩⲩⲡⲟⲇⲏⲙⲁ	2
ⲧⲉϥ ⲡⲟⲗⲓⲥ	ⲡⲟⲗⲓⲥ	2
ⲧ ϭⲟⲙ ⲙ ⲡ ⲛⲟⲩⲧⲉ ⲉⲧ ϣⲟⲟⲡ ⲛⲙⲙⲁ ϥ	ϭⲟⲙ	1
ⲧⲉⲕ ⲣⲓ ⲙ ⲡ ⲛⲁⲩ ⲉⲧ ⲕ ⲛⲁ ⲥⲱⲧⲙ	ⲣⲓ	1
ⲡⲁ ⲡ ⲛⲟⲩⲧⲉ	ⲡⲁ	1
ϩⲁⲣⲙⲁ	ϩⲁⲣⲙⲁ	1
ϩⲉⲛ ⲕⲉ ⲧⲟⲡⲟⲥ	ⲧⲟⲡⲟⲥ	1
ⲡⲉⲓ ⲙⲉⲉⲩⲉ	ⲙⲉⲉⲩⲉ	1
ϩⲃⲟⲟⲥ	ϩⲃⲟⲟⲥ	1
ⲛⲉⲧⲛ ⲟⲩⲉⲣⲏⲧⲉ	ⲟⲩⲉⲣⲏⲧⲉ	1
ⲡⲉⲧⲛ ϩⲏⲧ ⲛ ⲁⲧⲥⲃⲱ	ϩⲏⲧ	1
ⲡⲁⲓ ⲉⲛⲧ ⲁ ϥ ⲕⲟⲧ ϥ	ⲡⲁⲓ	1
ⲡ ⲥⲟⲛ ⲛ ⲑⲉⲟⲇⲱⲥⲓⲟⲥ ⲡ ⲣⲣⲟ	ⲥⲟⲛ	1
ⲟⲩⲏⲣ ⲛ ⲕⲟⲧ ⲉ ⲩ ⲙⲉϩ ⲛ ⲗⲁⲕⲙ	ⲟⲩⲏⲣ	1
ⲡⲉ ϩⲟⲟⲩ ⲛ ⲧⲉ ⲕⲣⲓⲥⲓⲥ	ϩⲟⲟⲩ	1
ⲡⲉⲕ ⲙⲁ ⲛ ϫⲟⲉⲓⲧ	ⲙⲁ	1
ⲡ ⲉⲧ ⲛⲁ ϯϣⲓⲡⲉ ⲅⲁⲣ ⲛⲁ ⲓ ⲙⲛ ⲛ ⲉⲧⲉ ⲛⲟⲩⲓ ⲛⲉ ϩⲛ ⲧⲉⲓ ⲅⲉⲛⲉⲁ ⲛ ⲛⲟⲉⲓⲕ . ⲁⲩⲱ ⲛ ⲣⲉϥⲣⲛⲟⲃⲉ	ⲡ	1
ⲡ ⲉⲧ ϩⲏⲛ ⲉϩⲟⲩⲛ ⲉ ⲡ ⲅⲉⲛⲟⲥ ⲛ ϩⲟⲩⲟ	ⲡ	1
ϩⲉⲛ ⲙⲁⲣⲅⲁⲣⲓⲧⲏⲥ	ⲙⲁⲣⲅⲁⲣⲓⲧⲏⲥ	1
ⲡ ⲛⲟⲩⲧⲉ ⲛ ⲧ ⲉⲓⲣⲏⲛⲏ	ⲛⲟⲩⲧⲉ	1
ϩⲉⲛ ϩⲁⲗⲩⲥⲓⲥ	ϩⲁⲗⲩⲥⲓⲥ	1
ⲟⲩ ⲇⲓⲱⲅⲙⲟⲥ	ⲇⲓⲱⲅⲙⲟⲥ	1
ⲟⲩ ⲉⲗⲁⲭⲓⲥⲧⲟⲛ	ⲉⲗⲁⲭⲓⲥⲧⲟⲛ	1
ⲁⲡⲁ ⲡⲁⲙⲃⲱ · ⲡⲉ ⲡⲣⲉⲥⲃⲩⲧⲉⲣⲟⲥ ⲛ ⲧ ⲉⲕⲕⲗⲏⲥⲓⲁ ⲛ ϣⲓⲏⲧ	ⲡⲁⲙⲃⲱ	1
ϩⲓⲃⲟⲗ	ϩⲓⲃⲟⲗ	1
ϩⲓⲟⲛⲉ	ϩⲓⲟⲛⲉ	1
ⲛ ⲉⲧ ⲣϩⲟⲩⲟ ⲉⲙⲁⲧⲉ ϩⲛ ϩⲉⲛ ⲙⲛⲧⲥⲟϭ	ⲛ	1
ⲛ ⲉⲧ ⲡⲏⲧ ⲛⲥⲱ ϥ ⲉⲧ ⲣ ⲡ ⲉⲧ ϩⲟⲟⲩ ⲛⲁ ϥ	ⲛ	1
ϫⲱ ϥ ⲙ ⲡ ⲕⲁϩ	ϫⲱ	1
ⲛ ⲕⲟⲥⲙⲟⲕⲣⲁⲧⲱⲣ ⲙ ⲡ ⲕⲁⲕⲉ	ⲕⲟⲥⲙⲟⲕⲣⲁⲧⲱⲣ	1
ϩⲉⲛ ⲕⲟⲩⲓ ⲛ ⲧⲓⲙⲏ	ⲕⲟⲩⲓ	1
ⲟⲩ ⲙⲩⲥⲧⲏⲣⲓⲟⲛ	ⲙⲩⲥⲧⲏⲣⲓⲟⲛ	1
ϣⲧⲏⲛ ⲛ ϣⲃⲛⲛⲉ	ϣⲧⲏⲛ	1
ⲟⲩ ϣⲱⲱⲧ ⲛⲏ ⲧⲛ	ϣⲱⲱⲧ	1
ϩⲟⲟⲗⲉ	ϩⲟⲟⲗⲉ	1
ⲡ ⲉⲧⲉ ⲛ ⲥⲉ ϯⲉⲟⲟⲩ ⲛⲁ ϥ ⲁⲛ ϩⲛ ⲛ ⲣⲱⲙⲉ	ⲡ	1
ⲡⲉϥ ⲟⲩⲱⲛϩ ⲉⲃⲟⲗ ϩⲙ ⲡ ⲓⲥⲣⲁⲏⲗ	ⲟⲩⲱⲛϩ	1
ⲓⲏⲥⲟⲩⲥ ⲡ ⲛⲁⲍⲱⲣⲁⲓⲟⲥ	ⲓⲏⲥⲟⲩⲥ	1
ⲡ ⲉⲧⲉ ⲟⲩⲛⲧ ϥ ⲛⲉ ⲭⲣⲏⲙⲁ	ⲡ	1
ⲛⲉⲩ ⲉⲛⲧⲟⲗⲏ	ⲉⲛⲧⲟⲗⲏ	1
ⲙ ⲙⲛⲧⲣⲉϥϣⲙϣⲉⲉⲓⲇⲱⲗⲟⲛ ⲉⲧ ϫⲁϩⲙ	ⲙⲛⲧⲣⲉϥϣⲙϣⲉⲉⲓⲇⲱⲗⲟⲛ	1
ⲡⲣⲉⲥⲃⲩⲧⲉⲣⲟⲥ	ⲡⲣⲉⲥⲃⲩⲧⲉⲣⲟⲥ	1
ϩⲧⲟⲟⲩ	ϩⲧⲟⲟⲩ	1
ⲡⲓ ⲁⲛⲟⲙⲟⲥ ⲛⲁⲃⲟⲩⲭⲟⲇⲟⲛⲟⲥⲟⲣ	ⲛⲁⲃⲟⲩⲭⲟⲇⲟⲛⲟⲥⲟⲣ	1
ⲟⲩ ⲣⲱⲙⲉ ⲛ ⲇⲓⲕⲁⲓⲟⲥ ⲉ ⲁ ϥ ⲧⲱⲧ ⲛ ϩⲏⲧ ⲛⲧⲟⲟⲧ ⲟⲩ ⲛ ϩⲉⲛ ⲣⲱⲙⲉ ⲙ ⲡⲓⲥⲧⲟⲥ	ⲣⲱⲙⲉ	1
ⲧⲉ ⲭⲱⲣⲁ ⲛ ⲛ ⲅⲉⲣⲁⲥⲏⲛⲟⲥ	ⲭⲱⲣⲁ	1
ⲛⲉ ⲡⲗⲩⲅⲏ · ⲉ ⲩ ϩⲓⲱⲱ ϥ	ⲡⲗⲩⲅⲏ	1
ϣⲧⲟⲣⲧⲣ	ϣⲧⲟⲣⲧⲣ	1
ⲟⲩⲁ ⲛⲉⲓ ⲕⲟⲩⲓ ⲉⲧ ⲥⲟⲃⲕ	ⲟⲩⲁ	1
ⲃⲉⲛⲓⲁⲙⲓⲛ	ⲃⲉⲛⲓⲁⲙⲓⲛ	1
ⲩ ⲙⲛⲧⲁⲡⲟⲥⲧⲟⲗⲟⲥ ⲛ ⲛ ϩⲉⲑⲛⲟⲥ	ⲙⲛⲧⲁⲡⲟⲥⲧⲟⲗⲟⲥ	1
ϩⲉⲛ ⲥϩⲁⲓ ⲉ ⲩ ⲟⲩⲁⲁⲃ ⲛⲁⲓ ⲉⲧ ⲛⲁ ⲉϣ ϭⲙϭⲟⲙ · ⲉ ⲧⲟⲩϫⲟ ⲕ	ⲥϩⲁⲓ	1
ⲧⲉ ⲑⲩⲥⲓⲁ	ⲑⲩⲥⲓⲁ	1
ⲛⲉϥ ⲟⲩⲉⲣⲏⲧⲉ	ⲟⲩⲉⲣⲏⲧⲉ	1
ⲡⲉⲧⲛ ϩⲱⲃ	ϩⲱⲃ	1
ⲡ ϣⲁϫⲉ ⲙ ⲡ ⲛⲟⲩⲧⲉ	ϣⲁϫⲉ	1
ⲧⲉ ϣⲧⲏⲛ ⲛ ⲧⲉⲓ ⲙⲓⲛⲉ	ϣⲧⲏⲛ	1
ⲡ ⲏⲓ ⲉⲧ ⲙⲙⲁⲩ	ⲏⲓ	1
ⲡ ⲉⲧⲉ ⲛ ϥ ⲛⲁ ϣⲟⲣⲡ ϥ ⲁⲛ · ⲛ ϥ ⲉⲓ ⲉ ϩⲧⲟⲟⲩⲉ ⲛ ⲧⲛ ⲃⲱⲕ ⲉ ⲡ ⲣⲡⲉ ϩⲓ ⲟⲩ ⲥⲟⲡ · ⲛ ⲧⲛ ⲑⲩⲥⲓⲁⲍⲉ ⲛ ⲛ ⲛⲟⲩⲧⲉ	ⲡ	1
ϫⲓⲛϫⲏ	ϫⲓⲛϫⲏ	1
ϩⲉⲛ ⲕⲉ ⲃⲁⲗ	ⲃⲁⲗ	1
ϩⲏ ⲙⲙⲟ ⲟⲩ	ϩⲏ	1
ⲡⲉⲧⲛ ϫⲟⲉⲓⲥ	ϫⲟⲉⲓⲥ	1
ⲛ ⲉⲛⲧ ⲁ ⲩ ϣⲱⲡⲉ ⲛⲁ ϥ ⲉⲃⲟⲗ ϩⲛ ⲗⲓⲁ	ⲛ	1
ⲡ ⲃⲁⲡⲧⲓⲥⲙⲁ	ⲃⲁⲡⲧⲓⲥⲙⲁ	1
ⲛ ⲉⲧ ⲣⲙⲛⲧⲛⲁ	ⲛ	1
ⲧ ⲉⲡⲓⲥⲧⲟⲗⲏ	ⲉⲡⲓⲥⲧⲟⲗⲏ	1
ⲛ ⲉⲧ ⲁϩⲉ ⲣⲁⲧ ⲟⲩ ⲙ ⲡⲉⲓ ⲙⲁ	ⲛ	1
ⲙⲏⲧ ⲛ ϣⲉ ⲛ ⲥⲧⲉⲓⲱϩⲉ ⲛ ϭⲱⲙ	ⲥⲧⲉⲓⲱϩⲉ	1
ⲟⲩ ⲫⲣⲁⲅⲉⲗⲗⲓⲟⲛ	ⲫⲣⲁⲅⲉⲗⲗⲓⲟⲛ	1
ⲛ ⲕⲟⲟⲩⲉ · ⲉⲧ ⲣϭⲣⲱⲱϩ	ⲕⲟⲟⲩⲉ	1
ⲛⲉⲩ ⲥⲡⲟⲧⲟⲩ	ⲥⲡⲟⲧⲟⲩ	1
ⲧⲉ ⲯⲩⲭⲏ ⲉⲧ ϫⲟⲟⲣ ϩⲛ ⲧ ⲙⲛⲧϩⲏⲕⲉ	ⲯⲩⲭⲏ	1
ⲛ ⲉⲧ ⲙⲟⲕϩ ⲧⲏⲣ ⲟⲩ ⲙⲛ ⲛ ⲉⲧ ⲣⲉⲛⲇⲁⲓⲙⲱⲛⲓⲟⲛ ⲛⲙⲙⲁ ⲩ	ⲛ	1
ⲡ ⲉⲧ ⲁⲛⲁⲕⲣⲓⲛⲉ	ⲡ	1
ⲧ ⲙⲛⲧⲥⲟϭ ⲛⲧⲉ ⲡ ⲛⲟⲩⲧⲉ	ⲙⲛⲧⲥⲟϭ	1
ϫⲟⲩⲱⲧ	ϫⲟⲩⲱⲧ	1
ⲡ ⲉⲛⲧ ⲁ ϥ ⲧⲣⲉ ⲛⲁ ⲙⲉⲉⲩⲉ · ⲙⲛ ⲛⲁ ϣⲟϫⲛⲉ ϣⲱⲡⲉ ⲉ ⲩ ⲣϩⲟⲩⲟ ⲉϩⲟⲩⲛ ⲉⲣⲟ ϥ	ⲡ	1
ⲡⲟⲩ ⲧⲱⲧ ⲛ ϩⲏⲧ	ⲧⲱⲧ	1
ⲕⲣⲟⲛⲟⲥ , ⲉⲧⲉ ⲛⲧⲟⲕ ⲡⲉ	ⲕⲣⲟⲛⲟⲥ	1
ϩⲉⲛ ⲉⲛⲉ ⲙ ⲙⲉ	ⲉⲛⲉ	1
ϩⲱⲃ ⲛⲓⲙ ⲉⲛⲧ ⲁ ⲧⲉⲥ ϣⲱⲙⲉ ϩⲱⲛ ⲙⲙⲟ ⲟⲩ ⲉⲧⲟⲟⲧ ⲥ	ϩⲱⲃ	1
ⲩ ⲣⲁⲥⲟⲩ ⲉⲣⲉ ⲛⲓⲙ ⲙⲛ ⲛⲓⲙ ϣⲱⲗ ⲙⲙⲟ ⲟⲩ ⲉⲃⲟⲗ ϩⲣⲁⲓ ϩⲛ ϩⲱⲃ ⲛⲓⲙ ⲙ ⲡⲟⲛⲏⲣⲟⲛ	ⲣⲁⲥⲟⲩ	1
ⲡ ϣⲏⲣⲉ ⲕⲟⲩⲓ	ϣⲏⲣⲉ	1
ⲟⲩⲟⲉⲓϣ ⲛⲓⲙ ⲛ ⲧⲉ ⲩϣⲏ ⲙⲛ ⲡⲉ ϩⲟⲟⲩ	ⲟⲩⲟⲉⲓϣ	1
ⲡⲉϥ ⲡⲉⲧⲛⲁⲛⲟⲩϥ ⲉⲧ ϥ ⲉⲓⲣⲉ ⲙⲙⲟ ϥ	ⲡⲉⲧⲛⲁⲛⲟⲩϥ	1
ϫⲱⲱⲙⲉ	ϫⲱⲱⲙⲉ	1
ⲡ ϣⲏⲣⲉ ⲛ ⲧⲉⲓ ϩⲙϩⲁⲗ	ϣⲏⲣⲉ	1
ⲭⲁⲓⲗⲉⲱⲛ	ⲭⲁⲓⲗⲉⲱⲛ	1
ⲁⲫⲑⲟⲛⲓⲁ	ⲁⲫⲑⲟⲛⲓⲁ	1
ⲡ ϫⲟⲉⲓⲥ ⲡⲉϥ ⲭⲣⲓⲥⲧⲟⲥ ⲓⲏⲥⲟⲩⲥ	ⲓⲏⲥⲟⲩⲥ	1
ⲛ ⲇⲁⲓⲙⲟⲛⲓⲟⲛ	ⲇⲁⲓⲙⲟⲛⲓⲟⲛ	1
ⲡ ⲙⲁ ⲉⲧⲉ ⲛ ϥ ⲛⲁ ϣⲉⲡ ⲧⲏⲩⲧⲛ ⲉⲣⲟ ϥ ⲁⲛ	ⲙⲁ	1
ϭⲁⲛⲁϩ	ϭⲁⲛⲁϩ	1
ⲧ ⲟⲩⲉⲣⲏⲧⲉ ⲛ ⲟⲩⲁ ⲉ ⲙⲛ ϭⲟⲙ ⲙⲙⲟ ϥ ⲉ ⲙⲟⲟϣⲉ ⲉ ⲉⲓ ⲉⲃⲟⲗ	ⲟⲩⲉⲣⲏⲧⲉ	1
ⲧⲁ ⲥⲱⲛⲉ	ⲥⲱⲛⲉ	1
ⲛ ⲛⲟⲩⲧⲉ ⲙ ⲡ ⲣⲣⲟ	ⲛⲟⲩⲧⲉ	1
ⲡ ⲧⲁⲉⲓⲟ ⲙ ⲡ ⲟⲩⲁ ⲡ ⲟⲩⲁ	ⲧⲁⲉⲓⲟ	1
ⲕⲉ ⲙⲁ	ⲙⲁ	1
ⲡ ϩⲁⲣϣϩⲏⲧ ⲉⲧⲉ ⲛⲁϣⲉ ⲡⲉϥ ⲛⲁ	ϩⲁⲣϣϩⲏⲧ	1
ⲡⲉⲓ ϫⲁⲓⲉ ⲉⲧ ⲓ ϣⲟⲟⲡ ⲛϩⲏⲧ ϥ	ϫⲁⲓⲉ	1
ⲓⲱⲥⲏⲫ ⲡ ⲇⲓⲕⲁⲓⲟⲥ	ⲓⲱⲥⲏⲫ	1
ⲃⲉⲉⲗⲍⲉⲃⲟⲩⲗ	ⲃⲉⲉⲗⲍⲉⲃⲟⲩⲗ	1
ⲧⲉϥ ⲧⲁⲡⲣⲟ	ⲧⲁⲡⲣⲟ	1
ⲧⲉϥ ⲭⲣⲉⲓⲁ ⲙⲁⲩⲁⲁ ϥ	ⲭⲣⲉⲓⲁ	1
ⲛⲁⲍⲁⲣⲉⲑ ⲛⲧⲉ ⲧ ⲅⲁⲗⲓⲗⲁⲓⲁ	ⲛⲁⲍⲁⲣⲉⲑ	1
ⲡ ⲛⲟⲩⲧⲉ ⲅⲁⲣ ⲡ ⲉⲧ ⲉⲛⲉⲣⲅⲉⲓ ⲛϩⲏⲧ ⲧⲏⲩⲧⲛ ⲙ ⲡ ⲟⲩⲱϣ ⲙⲛ ⲡ ϫⲱⲕ ⲉⲃⲟⲗ ⲙ ⲡ ⲟⲩⲱϣ	ⲛⲟⲩⲧⲉ	1
ϩⲉⲛ ⲁⲧⲑⲁⲃ	ⲁⲧⲑⲁⲃ	1
ⲧ ⲙⲛⲧⲣⲱⲙⲉ ⲧⲏⲣ ⲥ	ⲙⲛⲧⲣⲱⲙⲉ	1
ⲧ ⲥⲟⲟⲩϩⲥ	ⲥⲟⲟⲩϩⲥ	1
ⲡ ϭⲁϩϭϩ ⲛ ⲛ ⲟⲃϩⲉ	ϭⲁϩϭϩ	1
ϩⲱⲧ ⲛ ⲃⲣⲣⲉ	ϩⲱⲧ	1
ⲡⲁ ⲁⲅⲅⲉⲗⲟⲥ	ⲁⲅⲅⲉⲗⲟⲥ	1
ϥⲧⲟⲟⲩ ⲛ ϣⲉ ⲛ ϩⲧⲟ	ϩⲧⲟ	1
ϩⲧⲟⲟⲩⲉ ⲇⲉ ⲛ ⲥⲟⲩ ⲟⲩⲁ ⲙ ⲡⲁⲣⲙⲟⲩⲧⲉ	ϩⲧⲟⲟⲩⲉ	1
ⲟⲩ ϯ	ϯ	1
ⲡ ⲱⲛϩ ⲙ ⲡ ⲛⲟⲩⲧⲉ	ⲱⲛϩ	1
ⲛⲉⲓ ϭⲟⲙ ⲛ ⲧⲉⲓ ϭⲟⲧ ⲉⲧⲉⲣⲉ ⲡⲁⲓ ⲉⲓⲣⲉ ⲙⲙⲟ ⲟⲩ	ϭⲟⲙ	1
ⲛ ⲟⲓⲕⲟⲛⲟⲙⲟⲥ	ⲟⲓⲕⲟⲛⲟⲙⲟⲥ	1
ⲣⲱ ϥ	ⲣⲱ	1
ⲣⲱ ⲥ	ⲣⲱ	1
ⲛⲉ ⲭⲁⲣⲧⲏⲥ ⲉⲧ ⲥⲏϩ ϫⲓⲛ ⲛ ϣⲟⲣⲡ	ⲭⲁⲣⲧⲏⲥ	1
ⲛⲁ ⲧⲉⲓ ⲙⲓⲛⲉ	ⲛⲁ	1
ⲡ ϫⲓⲛϭⲟⲛⲥ ⲉⲧ ϫⲓ ⲉϩⲟⲩⲛ ⲉ ⲛ ⲉⲧ ϩⲓⲧⲟⲩⲱ ⲟⲩ	ϫⲓⲛϭⲟⲛⲥ	1
ⲡ ⲉⲛⲧ ⲁ ϥ ϭⲟⲗⲡ ⲥ ⲛⲁ ϥ ⲉ ⲥ ⲙⲟⲟⲩⲧ	ⲡ	1
ⲧ ⲙⲛⲧϩⲏⲧ ϣⲏⲙ	ⲙⲛⲧϩⲏⲧ	1
ⲉⲝⲟⲩⲥⲓⲁ	ⲉⲝⲟⲩⲥⲓⲁ	1
ⲛ ⲉⲧ ⲧⲛⲧⲱⲛ ⲉⲣⲟ ⲕ ϩⲛ ⲙ ⲙⲛⲧⲁⲡⲓⲥⲧⲟⲥ , ⲙⲛ ⲙⲛⲧⲁⲕⲁⲑⲁⲣⲧⲟⲥ ⲛⲓⲙ	ⲛ	1
ⲡ ⲉⲛⲧ ⲁ ϥ ⲧⲱⲙ ⲉ ⲣⲱ ϥ ⲙ ⲡ ϣⲱⲛⲉ ⲉⲧ ϩⲏⲡ ⲛ ⲧⲁ ⲯⲩⲭⲏ	ⲡ	1
ⲛⲁⲓ ⲕⲟⲩⲓ ⲉⲧ ⲡⲓⲥⲧⲉⲩⲉ ⲉⲣⲟ ⲓ	ⲛⲁⲓ	1
ⲡ ϣⲟⲩϣⲧ ⲉ ϥ ⲙⲉϩ ⲛ ϫⲱⲱⲙⲉ	ϣⲟⲩϣⲧ	1
ⲟⲩⲟⲛ ⲛⲓⲙ ⲉⲧ ⲟ ⲛ ⲟⲩ ϩⲏⲧ ⲛ ⲟⲩⲱⲧ ⲙⲛ ⲡ ⲛⲟⲩⲧⲉ ⲁⲩⲱ ⲙⲛ ⲛⲉⲛ ⲉⲓⲟⲧⲉ , ⲁⲩⲱ ⲛⲙⲙⲁ ⲛ ϩⲱⲱ ⲛ ⲟⲛ , ⲉⲓⲧⲉ ϩⲟⲟⲩⲧ ⲉⲓⲧⲉ ⲥϩⲓⲙⲉ . ⲉⲓⲧⲉ ⲛⲟϭ ⲉⲓⲧⲉ ⲕⲟⲩⲓ · ϩⲁⲧⲏ ⲛ , ⲁⲩⲱ ϩⲁⲧⲉ ⲧⲏⲩⲧⲛ	ⲟⲩⲟⲛ	1
ⲙⲛⲧϫⲁⲥⲓϩⲏⲧ	ⲙⲛⲧϫⲁⲥⲓϩⲏⲧ	1
ⲟⲩ ⲃⲉⲕⲉ	ⲃⲉⲕⲉ	1
ⲛⲉⲧⲛ ⲥⲛⲏⲩ	ⲥⲛⲏⲩ	1
ⲟⲩ ⲃⲗⲗⲉ	ⲃⲗⲗⲉ	1
ⲛⲉⲧⲛ ⲥⲱⲙⲁ	ⲥⲱⲙⲁ	1
ⲁⲡⲁ ⲕⲩⲣⲟⲥ	ⲕⲩⲣⲟⲥ	1
ⲡ ⲧⲟⲟⲩ ⲛ ϣⲙⲟⲩⲛ ⲛⲧⲉ ⲑⲏⲃⲁⲓⲥ	ⲧⲟⲟⲩ	1
ⲧⲁ ϭⲓⲛⲃⲱⲕ ϣⲁⲣⲟ ϥ	ϭⲓⲛⲃⲱⲕ	1
ⲡ ⲉⲧ ⲟⲩ ⲧⲁⲓⲟ ⲙⲙⲟ ϥ ⲡⲁⲣⲁ ⲡⲉϥ ⲙⲡϣⲁ · ⲏ ⲉ ϥ ϣⲟⲩϣⲟⲩ ⲙⲙⲟ ϥ ⲉϫⲱ ϥ	ⲡ	1
ⲡⲉ ⲥⲧⲉⲣⲉⲱⲙⲁ	ⲥⲧⲉⲣⲉⲱⲙⲁ	1
ⲛ ϣⲟϫⲛⲉ ⲛ ⲛ ϩⲏⲧ	ϣⲟϫⲛⲉ	1
ⲗⲁⲁⲩ ⲙ ⲡⲁⲑⲟⲥ	ⲗⲁⲁⲩ	1
ⲡⲁⲓ ⲉⲧ ⲛⲁ ⲣⲟⲩⲟⲉⲓⲛ ⲉ ⲛ ⲉⲧ ϩⲏⲡ ϩⲙ ⲡ ⲕⲁⲕⲉ	ⲡⲁⲓ	1
ⲟⲩ ⲗⲱϫϩ	ⲗⲱϫϩ	1
ⲟⲩ ⲙⲁϩⲉ	ⲙⲁϩⲉ	1
ⲡ ϩⲱⲃ ⲉⲧⲉ ϥ ⲕⲏ ⲛⲁ ⲓ ⲉϩⲣⲁⲓ ⲡⲁⲓ ⲉⲧⲉⲣⲉ ⲡⲉϥ ϫⲱⲕ ⲉⲃⲟⲗ ⲛⲁ ϣⲱⲡⲉ ⲛⲁ ⲓ ⲉⲃⲟⲗ ϩⲓⲧⲙ ⲡ ϫⲟⲉⲓⲥ	ϩⲱⲃ	1
ⲡ ⲏⲓ ϩⲙ ⲡ ⲛⲟⲩⲧⲉ	ⲏⲓ	1
ⲟⲩ ⲗⲁⲟⲥ	ⲗⲁⲟⲥ	1
ⲧⲟⲩ ⲡⲓⲥⲧⲓⲥ	ⲡⲓⲥⲧⲓⲥ	1
ⲡ ⲣⲁⲛ ⲛ ⲟⲩ ⲙⲁⲑⲏⲧⲏⲥ	ⲣⲁⲛ	1
ⲟⲩ ⲙⲟⲩⲥ	ⲙⲟⲩⲥ	1
ⲉⲡⲓⲥⲧⲏⲙⲏ	ⲉⲡⲓⲥⲧⲏⲙⲏ	1
ⲟⲩ ⲥⲏϥⲉ	ⲥⲏϥⲉ	1
ⲡⲉ ⲭⲣⲓⲥⲧⲟⲥ ⲓⲏⲥⲟⲩⲥ ⲡⲁⲓ ⲉⲛⲧ ⲁ ϥ ϣⲱⲡⲉ ⲛⲁ ⲛ ⲛ ⲥⲟⲫⲓⲁ ⲉⲃⲟⲗ ϩⲓⲧⲙ ⲡ ⲛⲟⲩⲧⲉ ⲛ ⲇⲓⲕⲁⲓⲟⲥⲩⲛⲏ ⲁⲩⲱ ⲛ ⲧⲃⲃⲟ ⲁⲩⲱ ⲛ ⲥⲱⲧⲉ	ⲓⲏⲥⲟⲩⲥ	1
ⲛⲁⲓ ⲉⲧⲉⲣⲉ ⲡ ϫⲟⲉⲓⲥ ϫⲱ ⲙⲙⲟ ⲥ ⲛⲁ ⲩ	ⲛⲁⲓ	1
ⲟⲩ ⲟⲉⲓⲉ	ⲟⲉⲓⲉ	1
ⲟⲩ ⲟⲉⲓⲕ	ⲟⲉⲓⲕ	1
ⲧⲉⲥ ϭⲓϫ	ϭⲓϫ	1
ⲟⲩ ⲣⲓⲙⲉ	ⲣⲓⲙⲉ	1
ⲧ ϭⲟⲙ ⲉⲛⲧ ⲁ ⲥ ⲉⲓ ⲉⲃⲟⲗ ⲙⲙⲟ ϥ	ϭⲟⲙ	1
ⲡⲉⲓ ⲛⲟϭ ⲛ ⲁⲛⲁⲭⲱⲣⲏⲧⲏⲥ	ⲁⲛⲁⲭⲱⲣⲏⲧⲏⲥ	1
ⲟⲩ ⲣⲧⲁⲃ	ⲣⲧⲁⲃ	1
ⲡⲉϥ ⲑⲣⲟⲛⲟⲥ	ⲑⲣⲟⲛⲟⲥ	1
ⲟⲩ ⲥⲁⲣⲝ	ⲥⲁⲣⲝ	1
ⲟⲩ ⲥⲛⲟϥ	ⲥⲛⲟϥ	1
ⲟⲩ ⲥⲧⲱⲧ	ⲥⲧⲱⲧ	1
ⲟⲩ ⲧⲁⲩⲟ	ⲧⲁⲩⲟ	1
ⲟⲩ ⲧⲟⲟⲩ	ⲧⲟⲟⲩ	1
ⲟⲩ ⲕⲟⲩⲓ ⲛ ⲑⲁⲃ	ⲕⲟⲩⲓ	1
ⲡⲟⲩ ⲃⲉⲕⲉ	ⲃⲉⲕⲉ	1
ⲟⲩ ⲧⲱⲣⲡ	ⲧⲱⲣⲡ	1
ⲛⲉ ϩⲃⲏⲩⲉ ⲛ ⲡⲟⲛⲏⲣⲟⲛ ⲉⲧ ⲙⲙⲁⲩ	ϩⲃⲏⲩⲉ	1
ⲥⲓⲟⲟⲩⲛⲉ	ⲥⲓⲟⲟⲩⲛⲉ	1
ⲟⲩ ⲯⲩⲭⲏ	ⲯⲩⲭⲏ	1
ⲁⲣⲏϫ ⲥ ⲛ ⲧ ⲟⲓⲕⲟⲩⲙⲉⲛⲏ	ⲁⲣⲏϫ	1
ⲡ ϫⲁⲓⲉ ⲛ ⲟⲩ ⲙⲁ ⲛ ϣⲱⲡⲉ	ϫⲁⲓⲉ	1
ⲡ ⲉⲛⲧ ⲁ ⲕ ϣⲁϫⲉ ϩⲛ ⲛⲉⲕ ⲡ ⲉⲧ ⲟⲩⲁⲁⲃ ⲙ ⲡⲣⲟⲫⲏⲧⲏⲥ ⲛⲛⲁϩⲣⲛ ⲡⲓ ⲃⲁⲃⲉⲣⲱⲙⲉ ⲉⲧ ⲙⲙⲁⲩ ⲫⲁⲣⲁⲱ ϫⲉ ⲕⲱ ⲉⲃⲟⲗ ⲙ ⲡⲁ ⲗⲁⲟⲥ	ⲡ	1
ⲡ ⲉⲛⲧ ⲁ ϥ ⲛⲁϩⲙ ⲧ ⲉⲃⲟⲗ ϩⲛ ⲛⲉ ⲫⲁⲛⲧⲁⲥⲓⲁ ⲙ ⲡⲣⲟⲥⲟⲩⲟⲉⲓϣ	ⲡ	1
ⲧⲁⲓ ⲉⲧⲉ ⲙⲡⲉ ⲗⲁⲁⲩ ⲛ ⲁⲣⲭⲱⲛ ⲛⲧⲉ ⲡⲉⲓ ⲁⲓⲱⲛ ⲥⲟⲩⲱⲛ ⲥ	ⲧⲁⲓ	1
ϩⲁϩ ⲛ ⲉⲩⲅⲉⲛⲏⲥ	ⲉⲩⲅⲉⲛⲏⲥ	1
ⲧ ⲁⲣⲭⲏ ⲙ ⲡ ⲥⲱⲛⲧ	ⲁⲣⲭⲏ	1
ⲩ ϩⲏⲧ ⲛ ϫⲟⲟⲩⲧ	ϩⲏⲧ	1
ⲧ ⲙⲛⲧϣⲁϥⲧⲉ ⲛ ⲛ ⲉⲧ ⲉⲓⲣⲉ ⲛ ⲧ ⲁⲛⲟⲙⲓⲁ ϩⲛ ⲟⲩ ϩⲱⲡ ⲏ ϩⲛ ⲟⲩⲱⲛϩ ⲉⲃⲟⲗ ϩⲣⲁⲓ ⲛϩⲏⲧ ⲛ	ⲙⲛⲧϣⲁϥⲧⲉ	1
ⲡⲟⲩ ⲙⲕⲁϩ	ⲙⲕⲁϩ	1
ϩⲱⲃ ⲛ ⲧⲉⲓ ϩⲉ	ϩⲱⲃ	1
ⲟⲩ ϣⲉⲉⲣⲉ ⲙⲙⲁⲩ ⲉⲣⲉ ⲟⲩ ⲡⲛⲉⲩⲙⲁ ⲛ ⲁⲕⲁⲑⲁⲣⲧⲟⲛ	ϣⲉⲉⲣⲉ	1
ⲕⲉ ⲙⲏⲏϣⲉ ⲉ ⲩ ϣⲱⲛⲉ	ⲙⲏⲏϣⲉ	1
ⲧⲉⲓ ⲥⲛⲧⲉ	ⲥⲛⲧⲉ	1
ⲧⲉ ϩⲣⲱ ⲛ ⲥⲁⲧⲉ	ϩⲣⲱ	1
ⲛⲉ ⲭⲣⲓⲥϯⲁⲛⲟⲥ	ⲭⲣⲓⲥϯⲁⲛⲟⲥ	1
ⲟⲩ ⲣⲱⲙⲉ ⲛ ⲟⲩⲱⲧ ⲉⲧⲉ ⲡ ⲛⲟⲩⲧⲉ ⲡⲉ	ⲣⲱⲙⲉ	1
ⲟⲩ ⲇⲓⲡⲛⲟⲛ	ⲇⲓⲡⲛⲟⲛ	1
ⲡ ⲉⲛⲧ ⲁ ⲛ ⲥⲙⲛ ⲧⲟⲟⲧ ⲛ ⲛⲙⲙⲁ ϥ ϩⲛ ⲟⲩ ⲇⲓⲁⲑⲏⲕⲏ	ⲡ	1
ⲛ ⲉⲧ ⲟⲩ ⲛⲁ ⲟⲩⲟⲙ ⲟⲩ	ⲛ	1
ⲛⲉⲓ ϩⲃⲏⲩⲉ ⲛ ⲟⲩⲱⲧ	ϩⲃⲏⲩⲉ	1
ⲕⲉ ϩⲏⲕⲉ	ϩⲏⲕⲉ	1
ⲧⲟⲩ ⲯⲩⲭⲏ ⲉⲧⲉ ⲙ ⲡ ⲕⲟⲥⲙⲟⲥ ⲧⲏⲣ ϥ ⲙⲡϣⲁ ⲙⲙⲟ ⲥ ⲁⲛ	ⲯⲩⲭⲏ	1
ⲛ ⲟⲩⲁϩⲓⲏⲧ ⲛ ⲁⲧⲛⲁ	ⲟⲩⲁϩⲓⲏⲧ	1
ⲁⲡⲁ ⲓⲥⲁⲕ	ⲓⲥⲁⲕ	1
ⲡ ⲉⲧ ⲛⲁ ⲧⲁⲕⲟ	ⲡ	1
ⲡ ⲥⲱϣ ⲉⲧ ϣⲟⲟⲡ ⲉⲃⲟⲗ ϩⲓⲧⲛ ⲧⲏⲩⲧⲛ	ⲥⲱϣ	1
ⲙⲛⲧⲥⲧⲙⲏⲧ ⲛⲓⲙ	ⲙⲛⲧⲥⲧⲙⲏⲧ	1
ⲡ ⲙⲁⲕⲁⲣⲓⲟⲥ ⲁⲡⲁ ⲡⲁⲙⲃⲱ ⲡⲉ ⲡⲣⲉⲥⲃⲩⲧⲉⲣⲟⲥ	ⲡⲁⲙⲃⲱ	1
ⲡ ⲙⲁ ⲉⲧ ⲟⲩ ⲛⲁ ⲱϩⲥ ⲛϩⲏⲧ ϥ	ⲙⲁ	1
ⲟⲩⲏⲣ ⲛ ⲃⲓⲣ ⲉ ⲩ ⲙⲉϩ ⲛ ⲗⲁⲕⲙ	ⲟⲩⲏⲣ	1
ⲡ ⲗⲓⲃⲁⲛⲟⲥ	ⲗⲓⲃⲁⲛⲟⲥ	1
ϩⲉⲛ ⲡⲁⲑⲟⲥ ⲉ ⲩ ⲥⲏϣ ⲉⲧⲉ ⲡ ϫⲓⲟⲩⲉ ⲡⲉ ⲙⲛ ⲡ ϫⲱϩⲙ ⲙⲛ ⲡⲟⲛⲏⲣⲟⲛ ⲛⲓⲙ	ⲡⲁⲑⲟⲥ	1
ⲙⲛⲧⲁⲧⲥⲱⲧⲙ ⲛⲓⲙ	ⲙⲛⲧⲁⲧⲥⲱⲧⲙ	1
ⲟⲩ ϥⲟⲧⲉ ⲙ ⲡ ϫⲟⲉⲓⲥ	ϥⲟⲧⲉ	1
ⲛ ⲉⲧ ⲣⲡⲉⲑⲟⲟⲩ ⲛⲁ ⲕ	ⲛ	1
ⲛ ⲉⲧ ⲕⲁⲙⲁ ⲙ ⲡ ⲥⲁⲧⲁⲛⲁⲥ ⲉ ⲧⲣⲉ ϥ ⲉⲓ ⲉϩⲟⲩⲛ	ⲛ	1
ⲟⲩⲁ ⲛ ⲧ ϩⲉ ⲛ ⲛⲓ ϣⲏⲣⲉ ϣⲏⲙ	ⲟⲩⲁ	1
ⲛ ⲉⲛⲧ ⲁ ϥ ⲟⲩⲉϩⲥⲁϩⲛⲉ ⲙⲙⲟ ⲟⲩ ⲛⲁ ⲩ ϫⲓⲛ ⲛ ϣⲟⲣⲡ	ⲛ	1
ⲛⲁ ⲏⲓ	ⲏⲓ	1
ϫⲱⲕⲙ ϩⲛ ϩⲉⲛ ⲥⲓⲟⲟⲩⲛⲉ	ϫⲱⲕⲙ	1
ϯ ⲁⲛⲟⲙⲓⲁ	ⲁⲛⲟⲙⲓⲁ	1
ⲛⲉⲧⲛ ⲉⲓⲟⲧⲉ	ⲉⲓⲟⲧⲉ	1
ⲛⲉⲓ ϩⲃⲏⲩⲉ ⲛ ⲧⲉⲓ ⲙⲓⲛⲉ	ϩⲃⲏⲩⲉ	1
ϩⲏⲣⲱⲇⲏⲥ ⲡ ⲣⲣⲟ	ϩⲏⲣⲱⲇⲏⲥ	1
ⲡ ⲏⲓ ⲙ ⲡ ⲁⲣⲭⲓⲥⲩⲛⲁⲅⲱⲅⲟⲥ	ⲏⲓ	1
ⲛⲉⲕ ϭⲓϫ	ϭⲓϫ	1
ⲧⲉ ⲭⲱⲣⲁ ⲧⲏⲣ ⲥ ⲉⲧ ⲙⲙⲁⲩ	ⲭⲱⲣⲁ	1
ⲟⲩ ϭⲓⲛϣⲁϫⲉ	ϭⲓⲛϣⲁϫⲉ	1
ⲧ ⲙⲛⲧⲣⲣⲟ ⲅⲁⲣ ⲙ ⲡ ⲛⲟⲩⲧⲉ	ⲙⲛⲧⲣⲣⲟ	1
ⲛ ⲥⲁϩⲟⲩ ⲧⲏⲣ ⲟⲩ ⲉⲛⲧ ⲁ ⲡⲉⲛ ⲉⲓⲱⲧ ϫⲟ ⲟⲩ	ⲥⲁϩⲟⲩ	1
ⲛ ⲣⲉϥⲛⲕⲟⲧⲕ ⲙⲛ ⲛ ϩⲟⲟⲩⲧ	ⲣⲉϥⲛⲕⲟⲧⲕ	1
ⲛ ⲓⲟⲩⲇⲁⲓ ⲧⲏⲣ ⲟⲩ	ⲓⲟⲩⲇⲁⲓ	1
ⲛ ⲕⲉ ϣⲁϫⲉ ⲉⲧ ⲛⲏⲩ ⲙⲛⲛⲥⲁ ⲛⲁⲓ	ϣⲁϫⲉ	1
ⲟⲩ ϩⲓⲕⲁⲛⲟⲥ ⲁⲛ ⲉ ⲡⲁϩⲧ ⲉ ⲃⲱⲗ ⲉⲃⲟⲗ ⲙ ⲡ ⲙⲟⲩⲥ ⲙ ⲡⲉϥ ⲧⲟⲟⲩⲉ	ϩⲓⲕⲁⲛⲟⲥ	1
ⲟⲩ ⲱⲛⲉ ⲛ ⲥⲓⲕⲉ	ⲱⲛⲉ	1
ⲡ ⲣⲱⲙⲉ ⲛ ϫⲁϫⲉ	ⲣⲱⲙⲉ	1
ⲛ ⲉⲧⲉ ⲟⲩⲛⲧⲁ ⲩ ⲅⲁⲣ ⲙⲙⲁⲩ ⲛ ⲧ ⲙⲛⲧⲣⲙⲙⲁⲟ ⲛ ⲁⲧⲧⲁⲕⲟ ϩⲙ ⲡⲉ ⲭⲣⲓⲥⲧⲟⲥ	ⲛ	1
ⲛ ⲉⲧ ⲙ ⲡⲉϥ ⲕⲱⲧⲉ ⲉⲧ ϩⲙⲟⲟⲥ ϩⲁϩⲧⲏ ϥ	ⲛ	1
ⲟⲩ ⲣⲙⲛⲕⲁϩ	ⲣⲙⲛⲕⲁϩ	1
ⲧ ⲉⲧ ⲕⲏ ⲉϩⲣⲁⲓ ⲉⲧⲉ ⲡⲁⲓ ⲡⲉ ⲓⲏⲥⲟⲩⲥ ⲡⲉ ⲭⲣⲓⲥⲧⲟⲥ	ⲧ	1
ⲛ ⲉⲛⲧ ⲁ ⲓⲏⲥⲟⲩⲥ ⲁⲁ ⲩ ⲛⲁ ϥ	ⲛ	1
ⲡ ⲉⲛⲧ ⲁ ϥ ⲕⲱ ϩⲣⲁⲓ ϩⲛ ⲧⲁ ⲯⲩⲭⲏ · ⲉ ⲧⲙ ⲕⲁ ⲗⲁⲁⲩ ⲛⲁ ⲓ · ⲛⲥⲁⲃⲗⲗⲁ ⲕ ⲙⲁⲩⲁⲁ ⲕ ⲡ ϫⲟⲉⲓⲥ	ⲡ	1
ⲧⲁⲓ ⲥⲟⲫⲓⲁ ⲛⲧ ⲁ ⲩ ⲧⲁⲁ ⲥ ⲙ ⲡⲁⲓ	ⲥⲟⲫⲓⲁ	1
ⲛⲁⲓ ⲉⲧ ⲕ ϣⲙϣⲉ ⲛⲁ ⲩ	ⲛⲁⲓ	1
ⲛ ⲉⲧ ϥ ϫⲡⲟ ⲙⲙⲟ ⲟⲩ	ⲛ	1
ⲧⲁ ⲡⲓⲥⲧⲓⲥ	ⲡⲓⲥⲧⲓⲥ	1
ⲡⲉϥ ⲟⲩⲟⲉⲓϣ	ⲟⲩⲟⲉⲓϣ	1
ⲡⲉϥ ϫⲡⲟ	ϫⲡⲟ	1
ⲙ ⲙⲛⲧⲛⲁ	ⲙⲛⲧⲛⲁ	1
ⲙ ⲙⲟⲥⲧⲉ	ⲙⲟⲥⲧⲉ	1
ⲡ ϯⲟⲩ ⲛ ⲟⲉⲓⲕ	ⲟⲉⲓⲕ	1
ⲡ ⲃⲟⲗ ⲛ ⲧ ⲡⲛⲛⲏ ⲙ ⲡ ⲣⲟ	ⲃⲟⲗ	1
ⲉϫⲛ ⲧ ⲡⲉⲧⲣⲁ ⲡ ⲙⲁ ⲉⲧⲉ ⲙⲙⲛ ϩⲁϩ ⲛ ⲕⲁϩ ⲛϩⲏⲧ ϥ	ⲡⲉⲧⲣⲁ	1
ⲡ ϣⲁϫⲉ ⲙ ⲡⲉ ⲡⲣⲟⲫⲏⲧⲏⲥ	ϣⲁϫⲉ	1
ⲛⲉⲕ ϣⲁϫⲉ ⲛ ⲕⲁⲃⲟⲗ	ϣⲁϫⲉ	1
ⲟⲩⲁ ⲉ ⲩ ⲙⲟⲩⲧⲉ ⲉⲣⲟ ϥ ϫⲉ ⲟⲩ ⲥⲟⲛ ⲡⲉ	ⲟⲩⲁ	1
ⲗⲉⲟⲩⲉⲓ ⲡ ϣⲏⲣⲉ ⲛ ⲁⲗⲫⲁⲓⲟⲥ	ⲗⲉⲟⲩⲉⲓ	1
ⲛⲁ ⲭⲗⲟⲏ	ⲛⲁ	1
ⲡ ϩⲏⲧ ⲛ ⲣⲱⲙⲉ	ϩⲏⲧ	1
ⲧⲉϥ ⲭⲣⲉⲓⲁ	ⲭⲣⲉⲓⲁ	1
ⲛⲁ ⲡ ⲣⲱⲙⲉ	ⲛⲁ	1
ⲟⲩ ⲛⲟϭ ⲛ ⲁⲅⲉⲗⲏ ⲛ ⲣⲓⲣ ⲉ ⲩ ⲙⲟⲟⲛⲉ ⲙⲙⲟ ⲥ	ⲁⲅⲉⲗⲏ	1
ⲛⲉⲕ ⲙⲁⲁϫⲉ	ⲙⲁⲁϫⲉ	1
ⲟⲩ ϩⲃⲥⲱ ⲛ ϩⲟⲉⲓⲧⲉ	ϩⲃⲥⲱ	1
ⲛⲉⲩ ϩⲃⲏⲩⲉ ⲙ ⲙⲉ	ϩⲃⲏⲩⲉ	1
ϩⲉⲛ ⲕⲟⲟⲩⲉ ⲛ ϫⲟⲩⲧⲏ ⲙ ⲙⲁⲁϫⲉ	ⲕⲟⲟⲩⲉ	1
ⲟⲩ ⲛⲟϭ ⲛ ⲥⲧⲩⲗⲗⲟⲥ ⲛ ⲛⲟⲩⲃ	ⲥⲧⲩⲗⲗⲟⲥ	1
ⲡⲉⲕ ϫⲓϫⲱⲓ	ϫⲓϫⲱⲓ	1
ⲛⲁ ⲛ ⲥⲙⲙⲉ ⲛ ⲛⲉⲧⲛ ⲉⲓⲟⲧⲉ	ⲛⲁ	1
ϯⲧⲉⲟⲩⲱ ⲙ ⲡ ϩⲏⲕⲉ ⲛ ⲛⲁⲏⲧ	ϯⲧⲉⲟⲩⲱ	1
ⲛⲁ ϣⲟϫⲛⲉ	ϣⲟϫⲛⲉ	1
ϩⲉⲛ ⲛⲟϭ ⲛ ϩⲩⲡⲉⲣⲉⲥⲓⲁ	ϩⲩⲡⲉⲣⲉⲥⲓⲁ	1
ⲧⲣⲟⲫⲏ ⲛ ⲟⲉⲓⲕ	ⲧⲣⲟⲫⲏ	1
ⲛ ⲉⲧ ϩⲙ ⲡ ϫⲁⲓⲉ	ⲛ	1
ϫⲟⲩⲧⲏ ⲙ ⲙⲁⲁϫⲉ	ϫⲟⲩⲧⲏ	1
ⲙⲕⲁϩ ⲛ ϩⲏⲧ	ⲙⲕⲁϩ	1
ϩⲉⲛ ⲉⲥⲟⲟⲩ	ⲉⲥⲟⲟⲩ	1
ⲛⲉⲕ ⲙⲉⲉⲩⲉ	ⲙⲉⲉⲩⲉ	1
ⲛ ⲉⲛⲧ ⲁ ⲩ ⲙⲟⲩ ϩⲙ ⲡ ⲣⲡⲉ	ⲛ	1
ⲟⲩ ⲛⲟϭ ⲅⲁⲣ ⲙ ⲙⲛⲧⲧⲉⲗⲓⲟⲥ	ⲙⲛⲧⲧⲉⲗⲓⲟⲥ	1
ⲟⲩ ϣⲓ ⲛ ⲉⲓⲱⲧ	ϣⲓ	1
ⲟⲩⲱϩⲉ ⲛ ⲣⲉϥϭⲉⲡⲣⲱⲙⲉ	ⲟⲩⲱϩⲉ	1
ⲛ ⲉⲛⲧⲟⲗⲏ	ⲉⲛⲧⲟⲗⲏ	1
ⲗⲁⲁⲩ ⲙⲙⲱ ⲧⲛ	ⲗⲁⲁⲩ	1
ⲛⲉⲓ ⲭⲁⲣⲧⲏⲥ ⲉⲧ ⲥⲏϩ ϫⲓⲛ ⲛ ϣⲟⲣⲡ	ⲭⲁⲣⲧⲏⲥ	1
ⲕⲟⲟⲩⲉ ⲛ ⲟⲩ ⲣⲧⲁⲃ	ⲕⲟⲟⲩⲉ	1
ⲛⲉ ⲕⲛⲁⲁⲩ	ⲕⲛⲁⲁⲩ	1
ⲛ ⲉⲧ ϩⲓϫⲙ ⲡ ⲕⲁϩ	ⲛ	1
ⲛ ⲉⲧⲉⲣⲉ ⲡⲉϥ ⲉⲓⲱⲧ ⲛⲁ ⲧⲁⲁ ⲩ ⲛⲁ ϥ	ⲛ	1
ⲡ ⲏⲓ ⲙ ⲫⲁⲣⲉⲥ ⲡⲁⲓ ⲉⲛⲧ ⲁ ⲑⲁⲙⲁⲣ ϫⲡⲟ ϥ ⲛ ⲓⲟⲩⲇⲁⲥ	ⲏⲓ	1
ⲧ ⲙⲁⲕⲁⲣⲓⲁ ⲥⲩⲛⲕⲗⲏⲧⲓⲕⲏ	ⲥⲩⲛⲕⲗⲏⲧⲓⲕⲏ	1
ⲛⲉϥ ⲁⲛⲟⲙⲓⲁ	ⲁⲛⲟⲙⲓⲁ	1
ⲧⲉ ⲑⲩⲥⲓⲁ ⲙ ⲡ ⲣⲣⲟ	ⲑⲩⲥⲓⲁ	1
ⲛⲉⲕ ⲙⲛⲧⲛⲁ	ⲙⲛⲧⲛⲁ	1
ⲧ ⲡⲟⲗⲓⲧⲉⲓⲁ ⲙ ⲡⲉⲛ ⲡⲉⲧⲟⲩⲁⲁⲃ ⲛ ⲉⲓⲱⲧ ⲉⲧ ⲧⲁⲓⲏⲩ ⲕⲁⲧⲁ ⲥⲙⲟⲧ ⲛⲓⲙ ⲡ ϩⲁⲅⲓⲟⲥ ⲁⲡⲁ ⲕⲩⲣⲟⲥ · ⲡ ⲧⲉⲗⲓⲟⲥ ⲛⲁⲙⲉ ⲛⲧ ⲁ ϥ ϩⲓⲥⲧⲟⲣⲓⲍⲉ ⲙⲙⲟ ϥ · ⲛϭⲓ ⲁⲡⲁ ⲡⲁⲙⲃⲱ ⲡⲉ ⲡⲣⲉⲥⲃⲩⲧⲉⲣⲟⲥ ⲛ ⲧ ⲉⲕⲕⲗⲏⲥⲓⲁ ⲛ ϣⲓⲏⲧ ⲛⲧ ⲁ ϥ ⲙⲧⲟⲛ ⲙⲙⲟ ϥ ⲛϭⲓ ⲡ ⲉⲧ ⲟⲩⲁⲁⲃ · ⲁⲡⲁ ⲕⲩⲣⲟⲥ ϩⲛ ⲥⲟⲩϣⲙⲟⲩⲛ ⲙ ⲡ ⲉⲃⲟⲧ ⲉⲡⲏⲡ ϩⲛ ⲟⲩ ⲉⲓⲣⲏⲛⲏ ⲛⲧⲉ ⲡ ⲛⲟⲩⲧⲉ	ⲡⲟⲗⲓⲧⲉⲓⲁ	1
ⲟⲩⲉϣ ⲛ ⲗⲩⲡⲉⲓ ⲙⲙⲟ ϥ	ⲟⲩⲉϣ	1
ⲛ ⲥⲩⲛⲕⲗⲓϯⲕⲟⲥ ⲙ ⲡ ⲡⲁⲗⲗⲁϯⲟⲛ	ⲥⲩⲛⲕⲗⲓϯⲕⲟⲥ	1
ⲡ ⲃⲓⲟⲥ ⲁⲩⲱ ⲧ ⲡⲟⲗⲓⲧⲉⲓⲁ ⲙ ⲡⲉⲛ ⲡⲉⲧⲟⲩⲁⲁⲃ ⲛ ⲉⲓⲱⲧ ⲉⲧ ⲧⲁⲓⲏⲩ ⲕⲁⲧⲁ ⲥⲙⲟⲧ ⲛⲓⲙ ⲁⲡⲁ ⲟⲛⲛⲟⲫⲣⲓⲟⲥ ⲡ ⲁⲛⲁⲭⲱⲣⲓⲧⲏⲥ ⲛⲧ ⲁ ϥ ϫⲱⲕ ⲉⲃⲟⲗ ⲙ ⲡⲉϥ ⲃⲓⲟⲥ ⲛ ⲥⲟⲩⲙⲛⲧⲧⲁⲥⲉ ⲙ ⲡ ⲉⲃⲟⲧ ⲡⲁⲱⲛⲉ ϩⲛ ⲟⲩ ⲉⲓⲣⲏⲛⲏ ⲛⲧⲉ ⲡ ⲛⲟⲩⲧⲉ	ⲃⲓⲟⲥ	1
ⲧ ⲡⲁⲣⲟⲩⲥⲓⲁ ⲙ ⲡ ⲛⲟⲩⲧⲉ	ⲡⲁⲣⲟⲩⲥⲓⲁ	1
ⲛⲉⲩ ⲉⲓⲟⲧⲉ	ⲉⲓⲟⲧⲉ	1
ⲡⲉϥ ⲙⲧⲟ ⲉⲃⲟⲗ	ⲙⲧⲟ	1
ⲁⲡⲁ ⲡⲁⲙⲟⲩⲛ · ⲡⲁ ⲙ ⲡⲟⲣⲕ	ⲡⲁⲙⲟⲩⲛ	1
ⲡ ⲱϩⲥ ⲛ ⲉⲓⲱⲧ	ⲱϩⲥ	1
ⲟⲩ ⲫⲁⲛⲧⲁⲥⲙⲁ	ⲫⲁⲛⲧⲁⲥⲙⲁ	1
ⲛ ⲉⲧ ϩⲙ ⲡ ⲛⲟⲙⲟⲥ	ⲛ	1
ⲧ ϣⲃⲓⲱ	ϣⲃⲓⲱ	1
ⲧ ϣⲏⲩⲉ	ϣⲏⲩⲉ	1
ⲧ ϣⲱⲙⲉ	ϣⲱⲙⲉ	1
ⲧ ϣⲱⲧⲉ	ϣⲱⲧⲉ	1
ϩⲉⲛ ⲙⲁ ⲉ ⲩ ϣⲟⲕϩ	ⲙⲁ	1
ⲧ ϩⲟⲧⲉ	ϩⲟⲧⲉ	1
ⲧⲁⲉⲓⲟ ⲙ ⲡ ⲛⲟⲩⲧⲉ	ⲧⲁⲉⲓⲟ	1
ⲡ ⲧⲟⲡ ⲙ ⲡⲉⲕ ϩⲟⲓⲧⲉ	ⲧⲟⲡ	1
ⲡ ⲛⲟⲩⲧⲉ ⲡ ϣⲁ ⲉⲛⲉϩ	ⲛⲟⲩⲧⲉ	1
ⲥⲡⲓⲣ ⲛ ⲛ ⲉⲧ ⲱϩⲥ	ⲥⲡⲓⲣ	1
ⲟⲩ ϣⲓ	ϣⲓ	1
ⲧ ⲙⲛⲧⲣⲣⲟ ⲉⲧ ⲙⲙⲁⲩ	ⲙⲛⲧⲣⲣⲟ	1
ⲡ ⲉⲧ ϩⲟⲟⲩ ⲉ ⲡⲁⲓ	ⲡ	1
ⲛ ⲉⲝⲟⲩⲥⲓⲁ	ⲉⲝⲟⲩⲥⲓⲁ	1
ϩⲣⲉ ⲉ ϥ ⲥⲃⲧⲱⲧ ⲛⲁ ⲛ	ϩⲣⲉ	1
ⲙ ⲡⲉⲓⲣⲁⲥⲙⲟⲥ ⲛ ⲛⲁ ⲧⲉⲓ ⲙⲓⲛⲉ	ⲡⲉⲓⲣⲁⲥⲙⲟⲥ	1
ⲡ ⲉⲛⲧ ⲁ ϥ ⲉⲓ ϣⲁⲣⲟ ⲕ	ⲡ	1
ⲟⲩ ⲙⲁ	ⲙⲁ	1
ⲟⲩ ⲥⲁ	ⲥⲁ	1
ⲟⲩ ⲥⲟ	ⲥⲟ	1
ⲡ ⲕⲁⲧⲁⲅⲉⲓⲟⲛ ⲙ ⲡ ⲥⲟⲛ ⲉⲧ ⲙⲙⲁⲩ	ⲕⲁⲧⲁⲅⲉⲓⲟⲛ	1
ⲟⲩ ⲙϩⲁⲟⲩ	ⲙϩⲁⲟⲩ	1
ⲛⲉⲕ ⲛⲟⲩⲧⲉ	ⲛⲟⲩⲧⲉ	1
ⲧ ϩⲏ ⲛ ⲛⲟϭ ⲉⲣⲟ ϥ	ϩⲏ	1
ϯⲟⲩ ⲛ ϣⲟ	ϣⲟ	1
ⲡ ⲉⲛⲧ ⲁ ϥ ⲧⲁⲙⲓⲉ ⲧⲏⲩⲧⲛ	ⲡ	1
ϩⲉⲛ ⲡⲛⲉⲩⲙⲁⲧⲓⲕⲟⲛ	ⲡⲛⲉⲩⲙⲁⲧⲓⲕⲟⲛ	1
ϩⲉⲛ ⲡⲛⲉⲩⲙⲁⲧⲓⲕⲟⲥ	ⲡⲛⲉⲩⲙⲁⲧⲓⲕⲟⲥ	1
ⲛ ⲥⲕⲉⲡⲁⲥⲧⲏⲥ	ⲥⲕⲉⲡⲁⲥⲧⲏⲥ	1
ⲩ ⲁⲅⲉⲗⲏ ⲛ ϣⲟϣ ⲉ ⲁ ⲥ ⲉⲓ ⲙ ⲡ ⲟⲩⲉ	ⲁⲅⲉⲗⲏ	1
ⲡ ⲉⲛⲧ ⲁ ϥ ⲥⲟⲣⲙ ⲉⲥ	ⲡ	1
ⲟⲩ ⲥⲕⲁⲛⲇⲁⲗⲟⲛ ⲛⲁ ⲩ	ⲥⲕⲁⲛⲇⲁⲗⲟⲛ	1
ϩⲩⲡⲟⲧⲁⲅⲏ ⲛⲓⲙ	ϩⲩⲡⲟⲧⲁⲅⲏ	1
ⲡ ⲙⲩⲥⲧⲏⲣⲓⲟⲛ	ⲙⲩⲥⲧⲏⲣⲓⲟⲛ	1
ⲧ ϩⲉⲛⲉⲉⲧⲏ	ϩⲉⲛⲉⲉⲧⲏ	1
ⲡ ⲣⲡⲉ ⲙ ⲡ ⲁⲡⲟⲗⲗⲱⲛ	ⲣⲡⲉ	1
ⲡ ⲉⲧ ⲉⲓⲣⲉ ⲙⲙⲟ ϥ ⲛ ⲛ ϣⲙⲙⲟ	ⲡ	1
ⲡⲓ ⲛⲟϭ ⲛ ⲃⲁⲣⲟⲥ	ⲃⲁⲣⲟⲥ	1
ⲙⲁ ⲛⲓⲙ ⲙ ⲡ ⲕⲱⲧⲉ ⲧⲏⲣ ϥ ⲛ ⲧ ⲅⲁⲗⲓⲗⲁⲓⲁ	ⲙⲁ	1
ⲛⲉⲕ ⲙⲁⲅⲉⲓⲣⲟⲥ	ⲙⲁⲅⲉⲓⲣⲟⲥ	1
ⲛ ϣⲏⲣⲉ ⲛ ⲟⲩ ⲙⲁⲁⲩ ⲛ ⲟⲩⲱⲧ ⲉⲧⲉ ⲧ ϩⲓⲉⲣⲟⲩⲥⲁⲗⲏⲙ ⲛ ⲧ ⲡⲉ ⲧⲉ	ϣⲏⲣⲉ	1
ⲧ ⲇⲓⲁⲕⲟⲛⲓⲁ ⲙ ⲡ ⲛⲟⲩⲧⲉ	ⲇⲓⲁⲕⲟⲛⲓⲁ	1
ⲟⲩ ⲙⲉⲉⲩⲉ ⲡⲉ ⲉ ϥ ϫⲟⲥⲉ ⲙ ⲙⲛⲧϫⲁⲥⲓϩⲏⲧ	ⲙⲉⲉⲩⲉ	1
ⲛ ⲉⲧ ⲛⲏϫ ⲛⲙⲙⲁ ϥ	ⲛ	1
ϩⲉⲛ ⲥⲛⲏⲩ ⲉ ⲩ ϣⲧⲣⲧⲱⲣ	ⲥⲛⲏⲩ	1
ⲓⲱϩⲁⲛⲏⲥ ⲡ ⲥⲟⲛ ⲛ ⲓⲁⲕⲱⲃⲟⲥ	ⲓⲱϩⲁⲛⲏⲥ	1
ⲉⲓϥⲧ	ⲉⲓϥⲧ	1
ⲛ ⲉⲧ ⲕⲱ ⲛ ϩⲧⲏ ⲩ ⲉ ⲕⲣⲟⲛⲟⲥ , ⲉⲧⲉ ⲛⲧⲟⲕ ⲡⲉ	ⲛ	1
ⲉⲓⲥ ⲟⲩ ⲥϩⲓⲙⲉ ⲉ ⲥ ⲛⲕⲟⲧⲕ ϩⲁⲣⲁⲧ ϥ	ⲥϩⲓⲙⲉ	1
ⲉⲩϩⲁ	ⲉⲩϩⲁ	1
ⲡⲉϥ ⲕⲉ ϣⲟⲙⲛⲧ ⲛ ϣⲃⲏⲣ	ϣⲃⲏⲣ	1
ⲁⲓⲱⲛ	ⲁⲓⲱⲛ	1
ⲟⲩ ⲣⲱⲙⲉ ⲉ ⲟⲩ ⲉⲃⲟⲗ ⲡⲉ ϩⲛ ⲃⲏⲑⲗⲉⲉⲙ ⲙ ⲡ ⲕⲁϩ ⲛ ⲓⲟⲩⲇⲁ	ⲣⲱⲙⲉ	1
ⲃⲟⲧⲉ	ⲃⲟⲧⲉ	1
ⲧ ⲥⲱϣⲉ ⲉⲧ ⲧⲁ ⲡⲉⲛ ⲥⲟⲛ ⲧⲉ ⲁⲃⲓⲙⲉⲗⲉⲭ ⲧⲁⲓ ⲉⲛⲧ ⲁ ⲩ ⲧⲁⲁ ⲥ ⲛ ⲛⲟⲉⲙⲓⲛ ⲧ ⲉⲛⲧ ⲁ ⲥ ⲕⲧⲟ ⲥ ⲉⲃⲟⲗ ϩⲛ ⲧ ⲥⲱϣⲉ ⲙ ⲙⲱⲁⲃ	ⲥⲱϣⲉ	1
ⲟⲩϣⲏ ⲛ ⲣⲟ	ⲟⲩϣⲏ	1
ⲧⲉⲩ ⲙⲛⲧϩⲏⲕⲉ	ⲙⲛⲧϩⲏⲕⲉ	1
ⲟⲩ ⲥⲡⲏⲗⲁⲓⲟⲛ	ⲥⲡⲏⲗⲁⲓⲟⲛ	1
ⲛⲓ ⲁⲧⲥⲃⲱ ⲁⲩⲱ ⲛⲓ ⲡⲁⲣⲑⲉⲛⲟⲥ ⲛ ⲥⲟϭ , ⲉⲧⲉ ⲙⲛ ⲛⲉϩ ϩⲛ ⲛⲉⲩ ⲁⲅⲅⲓⲟⲛ	ⲁⲧⲥⲃⲱ	1
ⲁⲡⲁ ⲡⲁⲏⲥⲉ	ⲡⲁⲏⲥⲉ	1
ⲛ ϣⲁϫⲉ ⲧⲏⲣ ⲟⲩ ⲙ ⲡⲉⲛ ϫⲟⲉⲓⲥ	ϣⲁϫⲉ	1
ⲉⲃⲓⲱ	ⲉⲃⲓⲱ	1
ⲉⲓⲁⲧ	ⲉⲓⲁⲧ	1
ⲉⲟⲟⲩ	ⲉⲟⲟⲩ	1
ⲧⲉⲩ ⲉⲛⲉⲣⲅⲉⲓⲁ	ⲉⲛⲉⲣⲅⲉⲓⲁ	1
ⲕⲱϩⲧ	ⲕⲱϩⲧ	1
ⲧ ⲉⲧⲉ ⲣⲡⲟⲥⲉ	ⲧ	1
ⲛⲏⲥⲧⲉⲓⲁ	ⲛⲏⲥⲧⲉⲓⲁ	1
ⲧ ⲡⲁⲣⲑⲉⲛⲟⲥ ⲉⲧ ⲟⲩⲁⲁⲃ ⲙⲁⲣⲓⲁ ⲧ ⲣⲉϥϫⲡⲉⲡⲛⲟⲩⲧⲉ	ⲙⲁⲣⲓⲁ	1
ⲡⲁⲓ ⲟⲛ ⲉⲛⲧ ⲁ ϥ ϫⲟⲟ ⲥ	ⲡⲁⲓ	1
ⲛ ⲣⲉϥϯϩⲉ	ⲣⲉϥϯϩⲉ	1
ⲟⲩ ⲥϩⲁⲓ ⲉⲃⲟⲗ ϩⲓⲣⲙ ⲡ ⲣⲟ ⲙ ⲡ ⲡⲁⲗⲗⲁϯⲟⲛ · ⲉ ϥ ⲥⲏϩ ⲛ ⲧⲉⲓ ϩⲉ	ⲥϩⲁⲓ	1
ϩⲁϩ ⲛ ⲥⲁⲉⲓⲛ	ⲥⲁⲉⲓⲛ	1
ⲓⲱⲥⲏ	ⲓⲱⲥⲏ	1
ⲡ ϫⲓⲥⲉ ⲙⲙⲟ ⲓ	ϫⲓⲥⲉ	1
ⲕⲣⲟϥ	ⲕⲣⲟϥ	1
ⲕⲛⲧⲉ	ⲕⲛⲧⲉ	1
ⲕⲟⲩⲓ	ⲕⲟⲩⲓ	1
ⲧ ⲁⲡⲟⲇⲓⲝⲓⲥ ⲛ ⲧ ⲙⲛⲧⲥⲧⲙⲏⲧ	ⲁⲡⲟⲇⲓⲝⲓⲥ	1
ⲧⲉ ⲫⲩⲗⲏ ⲙ ⲡⲉϥ ⲗⲁⲟⲥ	ⲫⲩⲗⲏ	1
ⲡⲉⲕ ⲣⲁⲛ ⲉⲧ ⲟⲩⲁⲁⲃ	ⲣⲁⲛ	1
ⲣⲙϩⲉ	ⲣⲙϩⲉ	1
ⲙⲁⲁⲩ	ⲙⲁⲁⲩ	1
ⲛⲉϥ ⲁⲡⲟⲥⲧⲟⲗⲟⲥ	ⲁⲡⲟⲥⲧⲟⲗⲟⲥ	1
ⲡⲉϥ ⲥⲧⲣⲁⲧⲉⲩⲙⲁ ⲧⲏⲣ ϥ	ⲥⲧⲣⲁⲧⲉⲩⲙⲁ	1
ⲥⲉ ⲛ ⲣⲟⲙⲡⲉ	ⲣⲟⲙⲡⲉ	1
ⲥⲓϣⲉ	ⲥⲓϣⲉ	1
ⲛⲁⲩⲏ	ⲛⲁⲩⲏ	1
ⲛⲟⲩϫ	ⲛⲟⲩϫ	1
ⲡⲉⲩ ⲥⲟⲟⲩⲛ ⲛ ⲛⲟⲩϫ	ⲥⲟⲟⲩⲛ	1
ⲟⲩ ⲁⲅⲁⲡⲏ · ⲛⲧⲉ ⲡ ⲛⲟⲩⲧⲉ	ⲁⲅⲁⲡⲏ	1
ⲧ ⲟⲩⲉϩⲥⲟⲓ	ⲟⲩⲉϩⲥⲟⲓ	1
ⲛ ϫⲁⲓⲃⲉⲕⲉ	ϫⲁⲓⲃⲉⲕⲉ	1
ⲟⲩⲟⲓ	ⲟⲩⲟⲓ	1
ⲟⲩⲱⲧ	ⲟⲩⲱⲧ	1
ⲡ ⲉⲛⲧ ⲁ ⲩ ϫⲟⲟ ϥ	ⲡ	1
ⲡ ⲱⲛⲉ ⲉⲧ ϩⲓϫⲛ ⲣⲱ ⲥ	ⲱⲛⲉ	1
ⲡⲏⲣⲁ	ⲡⲏⲣⲁ	1
ⲡⲣⲏϣ	ⲡⲣⲏϣ	1
ⲡⲱⲣϫ	ⲡⲱⲣϫ	1
ⲡⲉⲓⲣⲁⲥⲙⲟⲥ ⲛⲓⲙ ⲛⲧⲉ ⲡ ϫⲁϫⲉ	ⲡⲉⲓⲣⲁⲥⲙⲟⲥ	1
ⲩ ⲥⲕⲉⲩⲟⲥ	ⲥⲕⲉⲩⲟⲥ	1
ⲥⲙⲏⲧ	ⲥⲙⲏⲧ	1
ⲥⲙⲟⲧ	ⲥⲙⲟⲧ	1
ⲥⲙⲟⲩ	ⲥⲙⲟⲩ	1
ⲥⲛⲁⲩ	ⲥⲛⲁⲩ	1
ⲥⲛⲏⲩ	ⲥⲛⲏⲩ	1
ⲥⲟⲩⲟ	ⲥⲟⲩⲟ	1
ⲥⲧⲱⲧ	ⲥⲧⲱⲧ	1
ⲥⲱⲃⲉ	ⲥⲱⲃⲉ	1
ⲧⲃⲃⲟ	ⲧⲃⲃⲟ	1
ⲡⲉ ⲅⲣⲁⲙⲙⲁⲧⲉⲩⲥ	ⲅⲣⲁⲙⲙⲁⲧⲉⲩⲥ	1
ⲡⲉⲩ ⲃⲉⲕⲉ	ⲃⲉⲕⲉ	1
ⲧ ⲗⲩⲭⲛⲓⲁ	ⲗⲩⲭⲛⲓⲁ	1
ⲛⲉⲛ ϩⲃⲏⲩⲉ ⲛ ⲥⲙⲛⲟⲛ	ϩⲃⲏⲩⲉ	1
ⲗⲁⲁⲩ ⲛ ⲁⲡⲟⲗⲟⲅⲓⲁ	ⲗⲁⲁⲩ	1
ⲧ ⲙⲛⲧⲁⲧⲙⲟⲩ	ⲙⲛⲧⲁⲧⲙⲟⲩ	1
ⲧ ⲙⲛⲧⲁⲧⲟⲡⲕ	ⲙⲛⲧⲁⲧⲟⲡⲕ	1
ⲙ ⲙⲛⲧⲁⲧⲛⲁϩⲧⲉ	ⲙⲛⲧⲁⲧⲛⲁϩⲧⲉ	1
ⲡ ⲧⲟⲡⲟⲥ ⲉⲧ ⲟⲩ ϣⲓⲕⲉ ⲛϩⲏⲧ ϥ	ⲧⲟⲡⲟⲥ	1
ϫⲟⲩⲱⲧ ⲛ ϣⲉ	ϣⲉ	1
ⲙⲉⲧⲁⲛⲟⲓⲁ	ⲙⲉⲧⲁⲛⲟⲓⲁ	1
ⲛ ⲉⲧ ⲥⲙⲁⲁⲧ ⲛⲧⲉ ⲡⲁ ⲉⲓⲱⲧ	ⲛ	1
ⲙⲛⲧϣⲙⲏⲛ ⲛ ⲣⲟⲙⲡⲉ	ⲣⲟⲙⲡⲉ	1
ⲭⲗⲟⲏ	ⲭⲗⲟⲏ	1
ⲟⲩ ⲛⲟϭ ⲙ ⲙⲛⲧϫⲱⲱⲣⲉ	ⲙⲛⲧϫⲱⲱⲣⲉ	1
ⲡ ⲣⲙⲛϩⲏⲧ ⲉⲧ ⲣϩⲟⲧⲉ ϩⲏⲧ ϥ ⲙ ⲡ ϫⲟⲉⲓⲥ	ⲣⲙⲛϩⲏⲧ	1
ⲛ ⲁⲧϩⲏⲧ ⲛ ⲁⲧⲛⲁϩⲧⲉ	ⲁⲧϩⲏⲧ	1
ϩⲁϩ ⲛ ⲥⲟⲫⲟⲥ	ⲥⲟⲫⲟⲥ	1
ⲛⲁ ϩⲙϩⲁⲗ	ϩⲙϩⲁⲗ	1
ⲩ ϩⲱⲃ ⲛ ⲕⲣⲟϥ	ϩⲱⲃ	1
ⲡ ⲁⲣⲓⲥⲧⲟⲛ	ⲁⲣⲓⲥⲧⲟⲛ	1
ⲡⲉ ⲭⲣⲓⲥⲧⲟⲥ ⲛⲉ ⲛⲧ ⲁ ϥ ⲧⲁⲁ ⲩ ⲛⲁ ⲩ ⲉ ⲩ ⲁⲡⲟⲗⲁⲩⲥⲓⲥ . ⲁⲩⲱ ⲣⲣⲙⲙⲁⲟ ϩⲛ ϩⲉⲛ ϩⲃⲏⲩⲉ ⲉ ⲛⲁⲛⲟⲩ ⲟⲩ	ⲭⲣⲓⲥⲧⲟⲥ	1
ⲡⲁⲩⲗⲟⲥ ⲡ ⲁⲡⲟⲥⲧⲟⲗⲟⲥ ⲉⲧ ⲧⲁϩⲙ ⲙ ⲡⲉ ⲭⲣⲓⲥⲧⲟⲥ ⲓⲏⲥⲟⲩⲥ ϩⲓⲧⲙ ⲡ ⲟⲩⲱϣ ⲙ ⲡ ⲛⲟⲩⲧⲉ	ⲡⲁⲩⲗⲟⲥ	1
ⲡⲁⲓ ⲉⲧ ⲙⲙⲁⲩ ⲉⲧⲉ ⲓⲥⲙⲁⲏⲗ ⲡⲉ	ⲓⲥⲙⲁⲏⲗ	1
ⲛ ⲉⲧ ⲟⲩ ϯ ⲙⲙⲟ ⲟⲩ ⲛ ⲧⲁⲉⲓⲟ ⲙ ⲡ ⲛⲟⲩⲧⲉ	ⲛ	1
ⲙ ⲡⲏⲩ̣ⲉ	ⲡⲏⲩ̣ⲉ	1
ⲡ ⲙⲧⲟ ⲉⲃⲟⲗ ⲛ ⲧ ϣⲏⲩⲉ	ⲙⲧⲟ	1
ⲡⲉⲩ ⲕⲱⲧⲉ	ⲕⲱⲧⲉ	1
ϥⲧⲟⲩ ⲕⲱⲃ	ⲕⲱⲃ	1
ⲡⲉⲩ ⲙⲕⲁϩ	ⲙⲕⲁϩ	1
ⲛ ⲉⲧ ⲕⲱⲙϣ ⲛⲥⲁ ⲛ ⲉⲧ ϫⲱ ⲛ ⲧ ⲙⲉ ⲛ ⲟⲩⲟⲉⲓϣ ⲛⲓⲙ	ⲛ	1
ⲡⲉ ϩⲣⲟϣ ⲛ ⲧ ⲙⲛⲧⲛⲟϭ	ϩⲣⲟϣ	1
ⲟⲩ ⲛⲟϭ ⲛ ⲗⲩⲡⲏ	ⲗⲩⲡⲏ	1
ⲡ ϣⲏⲣⲉ ⲉⲧ ⲟⲓ ⲛⲧⲟⲟⲧ ⲥ	ϣⲏⲣⲉ	1
ⲡⲉⲩ ⲟⲩⲱϣ	ⲟⲩⲱϣ	1
ⲧⲉϥ ⲟⲣⲅⲏ	ⲟⲣⲅⲏ	1
ⲧⲉⲓ ⲅⲉⲛⲉⲁ ⲛ ⲛⲟⲉⲓⲕ . ⲁⲩⲱ ⲛ ⲣⲉϥⲣⲛⲟⲃⲉ	ⲅⲉⲛⲉⲁ	1
ⲡ ⲉⲧ ϭⲱⲡⲉ ⲛ ⲛ ⲥⲟⲫⲟⲥ ϩⲛ ⲛⲉⲩ ⲕⲟⲧⲥ	ⲡ	1
ⲟⲩⲁ ⲉⲃⲟⲗ ϩⲙ ⲡ ⲙⲏⲏϣⲉ	ⲟⲩⲁ	1
ⲕⲱⲧ ⲙ ⲡ ⲛⲟⲩⲧⲉ	ⲕⲱⲧ	1
ⲧⲉⲩ ⲛⲟⲩⲛⲉ ⲧⲏⲣ ⲥ	ⲛⲟⲩⲛⲉ	1
ⲙ ⲡⲟⲗⲓⲥ	ⲡⲟⲗⲓⲥ	1
ⲛ ⲉⲧ ⲧⲃⲃⲏⲩ ϩⲙ ⲡⲉ ⲭⲣⲓⲥⲧⲟⲥ ⲓⲏⲥⲟⲩⲥ ⲛ ⲉⲧ ⲧⲁϩⲙ ⲉⲧ ⲟⲩⲁⲁⲃ	ⲛ	1
ⲟⲩ ϩⲏⲧ ⲙ ⲙⲛⲧϣⲙⲙⲟ	ϩⲏⲧ	1
ⲛⲉⲓ ⲃⲓⲣ	ⲃⲓⲣ	1
ⲡ ⲥⲉⲉⲡⲉ ⲛ ⲛⲉϥ ⲛⲟⲩⲧⲉ ⲛ ϩⲟⲟⲩⲧ ϩⲓ ⲥϩⲓⲙⲉ	ⲥⲉⲉⲡⲉ	1
ⲡ ⲁⲅⲅⲉⲗⲟⲥ ⲉⲧ ⲙⲟⲟϣⲉ ⲛⲙⲙⲁ ϥ	ⲁⲅⲅⲉⲗⲟⲥ	1
ⲡⲉⲩ ϩⲱⲃ ⲛ ϭⲓϫ	ϩⲱⲃ	1
ⲙ ⲙⲩⲥⲧⲏⲣⲓⲟⲛ ⲙ ⲡ ⲛⲟⲩⲧⲉ	ⲙⲩⲥⲧⲏⲣⲓⲟⲛ	1
ⲧ ϩⲟⲣⲙⲏ ⲙ ⲡⲉ ⲡⲛⲉⲩⲙⲁ	ϩⲟⲣⲙⲏ	1
ⲛ ϫⲃⲃⲉⲥ ⲉⲧ ϫⲉⲣⲟ	ϫⲃⲃⲉⲥ	1
ⲡ ⲥⲱⲧⲏⲣ ⲙⲁⲩⲁⲁ ϥ · ⲁⲩⲱ ⲡ ⲇⲓⲕⲁⲓⲟⲥ · ⲡ ⲉⲧ ϣⲟⲟⲡ ϩⲙ ⲙⲁ ⲛⲓⲙ · ⲡ ⲉⲧ ϣⲱⲱⲡ ϫⲓⲛ ⲉⲛⲉϩ · ⲡ ⲛⲟⲩⲧⲉ ⲡⲉ ⲭⲣⲓⲥⲧⲟⲥ ⲓⲏⲥⲟⲩⲥ	ⲓⲏⲥⲟⲩⲥ	1
ⲡⲉⲓ ⲕⲉ ⲟⲩⲁ	ⲟⲩⲁ	1
ϩⲩⲡⲏⲣⲉⲧⲏⲥ ⲙ ⲡⲉ ⲭⲣⲓⲥⲧⲟⲥ	ϩⲩⲡⲏⲣⲉⲧⲏⲥ	1
ϣⲏⲧ ⲛ ⲕⲉⲣⲱⲛ ⲛ ⲛⲟⲩⲃ	ⲕⲉⲣⲱⲛ	1
ⲡⲉ ⲡⲛⲉⲩⲙⲁ ⲉⲧ ⲟⲩⲁⲁⲃ ⲉⲧ ⲛϩⲏⲧ ⲧⲏⲩⲧⲛ . ⲡⲁⲓ ⲉⲛⲧ ⲁ ⲧⲉⲧⲛ ϫⲓⲧ ϥ ⲉⲃⲟⲗ ϩⲓⲧⲙ ⲡ ⲛⲟⲩⲧⲉ	ⲡⲛⲉⲩⲙⲁ	1
ϩⲉⲛ ⲭⲁⲗⲕⲓⲛ	ⲭⲁⲗⲕⲓⲛ	1
ϩⲣⲟⲩⲑ ⲧ ⲙⲱⲁⲃⲓⲧⲏⲥ ⲧ ϩⲓⲙⲉ ⲙ ⲡ ⲉⲛⲧ ⲁ ϥ ⲙⲟⲩ	ϩⲣⲟⲩⲑ	1
ϥⲧⲟⲟⲩ ⲛ ⲣⲱⲙⲉ	ⲣⲱⲙⲉ	1
ⲡⲁ ⲁⲡⲟⲗⲗⲱ	ⲡⲁ	1
ϩⲉⲛ ⲭⲁⲣⲧⲏⲥ	ⲭⲁⲣⲧⲏⲥ	1
ⲩ ⲕⲁⲡⲛⲟⲥ ⲉ ϥ ⲛⲏⲩ ⲉⲃⲟⲗ ϩⲛ ⲧⲉϥ ⲧⲁⲡⲣⲟ	ⲕⲁⲡⲛⲟⲥ	1
ⲛⲉⲕ ϣⲁϫⲉ ⲛ ⲉⲡⲣⲁ	ϣⲁϫⲉ	1
ϩⲉⲛ ϩⲏⲃⲥ ⲉ ⲁ ⲩ ϫⲉⲣⲱ ⲟⲩ ϩⲛ ϩⲉⲛ ⲙⲁ ⲛ ⲕⲁⲕⲉ	ϩⲏⲃⲥ	1
ⲛ ⲉⲧ ⲧⲁϩⲉ ⲁϫⲛ ⲏⲣⲡ	ⲛ	1
ⲧ ⲉⲧ ⲙⲙⲁⲩ	ⲧ	1
ⲧ ⲉⲧ ⲥⲁϣⲉ	ⲧ	1
ⲛⲉⲕ ⲉⲩⲣⲓⲡⲟⲥ	ⲉⲩⲣⲓⲡⲟⲥ	1
ⲡ ⲧⲟⲡ ⲛ ⲧⲉϥ ϣⲧⲏⲛ	ⲧⲟⲡ	1
ⲡ ⲉⲧⲉ ⲟⲩⲁϣ ϥ	ⲡ	1
ⲡ ⲙⲁ ⲛ ϣⲉⲗⲉⲉⲧ	ⲙⲁ	1
ⲡⲁ ⲥⲁ ⲛϩⲟⲩⲛ	ⲥⲁ	1
ⲛⲉⲩ ⲙⲛⲧⲁⲕⲁⲑⲁⲣⲧⲟⲥ	ⲙⲛⲧⲁⲕⲁⲑⲁⲣⲧⲟⲥ	1
ⲁⲡⲁ ⲥⲁⲣⲁⲡⲓⲟⲛ	ⲥⲁⲣⲁⲡⲓⲟⲛ	1
ⲟⲩ ⲡⲟⲣⲛⲉⲓⲁ ⲛ ⲧⲉⲓ ⲙⲓⲛⲉ ⲉ ⲛ ⲥ ϩⲛ ⲛ ⲕⲉ ϩⲉⲑⲛⲟⲥ ⲁⲛ	ⲡⲟⲣⲛⲉⲓⲁ	1
ⲑⲁⲗⲁⲥⲥⲁ ⲛ ⲧ ⲅⲁⲗⲓⲗⲁⲓⲁ	ⲑⲁⲗⲁⲥⲥⲁ	1
ⲡ ⲛⲁⲩ ⲛ ⲟⲩⲱⲙ	ⲛⲁⲩ	1
ϩⲁϩ ⲛ ⲇⲁⲓⲙⲱⲛⲓⲟⲛ	ⲇⲁⲓⲙⲱⲛⲓⲟⲛ	1
ⲁⲫⲑⲟⲛⲓⲁ ⲧ ϣⲉⲉⲣⲉ ⲙ ⲡ ⲕⲟⲙⲉⲥ ⲁⲗⲉⲝⲁⲛⲇⲣⲟⲥ	ⲁⲫⲑⲟⲛⲓⲁ	1
ⲛ ⲛ ⲉⲧ ⲛⲁ ϩⲉ ⲉⲃⲟⲗ	ⲛ	1
ⲛ ϭⲓⲛⲟⲩⲟⲟⲙ ⲧⲏⲣ ⲟⲩ	ϭⲓⲛⲟⲩⲟⲟⲙ	1
ⲛⲉⲩ ⲁⲅⲅⲓⲟⲛ	ⲁⲅⲅⲓⲟⲛ	1
ⲡ ⲙⲁⲕⲁⲣⲓⲟⲥ ⲁⲡⲁ ⲑⲉⲱⲫⲓⲗⲟⲥ ⲡ ⲁⲣⲭⲏⲉⲡⲓⲥⲕⲟⲡⲟⲥ	ⲑⲉⲱⲫⲓⲗⲟⲥ	1
ⲡⲁⲓ ⲛⲧ ⲁ ⲕ ⲁⲁ ϥ ⲛ ⲃⲣⲣⲉ ϩⲛ ⲟⲩ ⲙⲛⲧⲁⲥ	ⲡⲁⲓ	1
ⲛ ⲁⲓⲱⲛ ⲧⲏⲣ ⲟⲩ ⲛ ⲛ ⲁⲓⲱⲛ	ⲁⲓⲱⲛ	1
ⲙⲟϫ ⲛ ϣⲁⲁⲣ	ⲙⲟϫ	1
ⲡ ⲧⲣⲉ ⲡⲉⲧⲛ ϩⲏⲧ ⲛ ⲁⲧⲥⲃⲱ ⲣⲕⲁⲕⲉ ⲉⲣⲱ ⲧⲛ	ⲧⲣⲉ	1
ⲛ ⲧⲉⲗⲉⲓⲟⲥ	ⲧⲉⲗⲉⲓⲟⲥ	1
ⲧⲁ ⲙⲛⲧⲁⲑⲏⲧ	ⲙⲛⲧⲁⲑⲏⲧ	1
ⲡⲉϥ ⲁϩⲉ	ⲁϩⲉ	1
ⲡⲉⲕ ϩⲟⲓⲧⲉ	ϩⲟⲓⲧⲉ	1
ⲡ ⲉⲧ ϫⲓ ⲉϩⲟⲩⲛ ⲉ ⲡ ⲅⲉⲛⲟⲥ	ⲡ	1
ⲧⲁ ⲙⲛⲧⲃⲣⲣⲉ	ⲙⲛⲧⲃⲣⲣⲉ	1
ϯ ⲅⲛⲱⲙⲏ ⲛ ⲟⲩⲱⲧ	ⲅⲛⲱⲙⲏ	1
ⲟⲩ ⲕⲟⲩⲓ ⲛ ⲕⲁⲧⲁⲅⲉⲓⲟⲛ	ⲕⲟⲩⲓ	1
ⲙⲛⲧⲗⲏⲥⲧⲏⲥ	ⲙⲛⲧⲗⲏⲥⲧⲏⲥ	1
ⲙⲛⲧϣⲙⲙⲟ	ⲙⲛⲧϣⲙⲙⲟ	1
ⲧⲉⲩ ⲏⲡⲉ	ⲏⲡⲉ	1
ⲟⲩ ⲙⲛⲧϩⲁⲣϣϩⲏⲧ ⲉϫⲙ ⲡⲉϥ ⲥⲟⲛ	ⲙⲛⲧϩⲁⲣϣϩⲏⲧ	1
ϩⲉⲛ ⲇⲓⲁⲕⲱⲛ	ⲇⲓⲁⲕⲱⲛ	1
ⲧ ⲁⲅⲁⲡⲏ ⲙ ⲡⲉ ⲭⲣⲓⲥⲧⲟⲥ	ⲁⲅⲁⲡⲏ	1
ⲧⲉⲓ ⲉⲡⲓⲥⲧⲟⲗⲏ	ⲉⲡⲓⲥⲧⲟⲗⲏ	1
ⲛ ⲉⲧ ⲣϭⲣⲱϩ	ⲛ	1
ⲥⲁϣϥ ⲛ ⲃⲓⲣ	ⲃⲓⲣ	1
ⲡⲉϥ ⲕⲁϩ	ⲕⲁϩ	1
ⲟⲩ ⲡⲣⲟⲧⲉⲕⲧⲱⲣ ⲧⲁϩⲟ ϥ · ⲉ ⲡⲉϥ ⲣⲁⲛ ⲡⲉ ⲃⲁⲥⲓⲗⲉⲓⲧⲏⲥ	ⲃⲁⲥⲓⲗⲉⲓⲧⲏⲥ	1
ϩⲉⲛ ϣⲏⲓ ⲉ ⲩ ⲟⲩⲟϭⲡ ϩⲙ ⲡ ⲧⲣⲉ ⲡⲉⲧⲛ ϩⲏⲧ ⲛ ⲁⲧⲥⲃⲱ ⲣⲕⲁⲕⲉ ⲉⲣⲱ ⲧⲛ	ϣⲏⲓ	1
ⲟⲩ ⲡ ⲉⲧ ⲛⲁⲛⲟⲩ ϥ ⲛ ⲟⲩⲱⲧ	ⲡ	1
ⲟⲩ ϣⲱϣ	ϣⲱϣ	1
ⲟⲩ ϣⲟⲧ	ϣⲟⲧ	1
ⲟⲩ ϩⲁⲡ	ϩⲁⲡ	1
ⲟⲩ ϩⲙⲥ	ϩⲙⲥ	1
ⲟⲩ ϩⲣⲉ	ϩⲣⲉ	1
ⲟⲩ ϩⲱⲃ	ϩⲱⲃ	1
ⲟⲩ ϩⲱⲥ	ϩⲱⲥ	1
ⲟⲩ ϫⲡⲟ	ϫⲡⲟ	1
ⲛⲁ ϣⲃⲉⲉⲣ	ϣⲃⲉⲉⲣ	1
ⲛ ϩⲗⲗⲟ ⲁ ⲩ ⲣϩⲁϩ ⲛ ⲣⲟⲙⲡⲉ	ϩⲗⲗⲟ	1
ⲧ ⲙⲁⲥⲧⲓⲅⲝ ⲉⲧ ⲛⲙⲙⲁ ⲥ	ⲙⲁⲥⲧⲓⲅⲝ	1
ⲧ ⲕⲟⲗⲁⲥⲓⲥ ⲉⲧ ⲛⲁ ϣⲱⲡⲉ	ⲕⲟⲗⲁⲥⲓⲥ	1
ⲟⲩ ⲃⲁⲗ ⲟⲩⲱⲧ	ⲃⲁⲗ	1
ⲡⲓ ϣⲁϫⲉ ⲛ ⲟⲩⲱⲧ	ϣⲁϫⲉ	1
ⲧ ⲙⲛⲧϩⲙϩⲁⲗ ⲛ ⲛⲉ ϩⲃⲏⲩⲉ ⲛ ⲛⲓ ⲣⲱⲙⲉ ⲉⲧ ⲙⲉⲉⲩⲉ ⲉ ϩⲉⲛ ⲡⲟⲛⲏⲣⲟⲛ ⲛ ⲛⲁⲩ ⲛⲓⲙ ⲉϩⲟⲩⲛ ⲉⲣⲟ ⲟⲩ	ⲙⲛⲧϩⲙϩⲁⲗ	1
ⲥⲕⲁⲛⲇⲁⲗⲟⲛ	ⲥⲕⲁⲛⲇⲁⲗⲟⲛ	1
ⲡ ⲉⲛⲧ ⲁ ϥ ϫⲡⲟ ⲇⲉ ⲛⲁ ϥ ⲛ ϩⲉⲛ ⲙⲁⲣⲅⲁⲣⲓⲧⲏⲥ . ⲏ ⲟⲩ ⲛⲟⲩⲃ	ⲡ	1
ⲛⲉ ϩⲃⲏⲩⲉ ⲉⲧⲉ ϩⲉⲛ ⲇⲓⲕⲁⲓⲟⲛ ⲁⲛ ⲛⲉ	ϩⲃⲏⲩⲉ	1
ⲟⲩ ⲛⲟϭ ⲙ ⲙⲏⲏϣⲉ	ⲙⲏⲏϣⲉ	1
ⲡ ⲧⲃⲧ ⲥⲛⲁⲩ	ⲧⲃⲧ	1
ⲧ ⲥⲩⲛⲏⲑⲓⲁ ϣⲱⲡⲉ · ⲉⲧ ⲣ ⲛ ⲁⲡⲁⲛⲧⲁ ⲉ ⲛⲉⲛ ⲉⲣⲏⲩ	ϣⲱⲡⲉ	1
ⲡ ⲃⲟⲗ ⲙ ⲡⲉⲓ ⲙⲁ	ⲃⲟⲗ	1
ⲛⲉ ⲫⲁⲛⲧⲁⲥⲓⲁ ⲙ ⲡⲣⲟⲥⲟⲩⲟⲉⲓϣ	ⲫⲁⲛⲧⲁⲥⲓⲁ	1
ⲙⲛⲧⲁⲧⲥⲃⲱ ⲛⲓⲙ	ⲙⲛⲧⲁⲧⲥⲃⲱ	1
ⲟⲩ ⲛⲟϭ ⲙ ⲙⲟⲕϩⲥ	ⲙⲟⲕϩⲥ	1
ⲡⲉ ϩⲟⲟⲩ ⲙ ⲡⲉϥ ⲟⲩⲱⲛϩ ⲉⲃⲟⲗ ϩⲙ ⲡ ⲓⲥⲣⲁⲏⲗ	ϩⲟⲟⲩ	1
ⲧ ⲕⲟⲓⲛⲱⲛⲓⲁ ⲛⲧ ⲁ ⲥ ϣⲱⲡⲉ ⲉϩⲟⲩⲛ ⲉⲣⲱ ⲧⲛ	ⲕⲟⲓⲛⲱⲛⲓⲁ	1
ⲍⲱⲟⲛ ⲛⲓⲙ	ⲍⲱⲟⲛ	1
ⲡ ⲉⲛⲧ ⲁ ϥ ⲥⲱⲛⲧ ⲙ ⲡⲉ ⲕⲗⲟⲙ ⲛ ⲛ ⲉⲧ ⲟⲩⲁⲁⲃ ⲧⲏⲣ ⲟⲩ · ⲙⲛ ⲛⲉⲓ ⲟⲩⲟⲧⲟⲩⲉⲧ ⲉⲧ ⲟϣ · ⲉ ⲁ ϥ ϣⲟⲃⲟⲩ ϩⲛ ⲛⲉ ⲣⲱⲙⲉ · ⲡⲉⲕ ϩⲣⲏⲣⲉ · ⲉⲧⲉ ⲙⲉ ϥ ϩⲱϭⲃ ϣⲁⲃⲟⲗ	ⲡ	1
ⲛⲉ ϩⲃⲏⲩⲉ ⲙ ⲡ ⲕⲁⲕⲉ ⲉⲧⲉ ⲙⲙⲛⲧ ⲟⲩ ⲕⲁⲣⲡⲟⲥ	ϩⲃⲏⲩⲉ	1
ⲟⲩⲟⲛ ⲛⲓⲙ ⲉⲓⲣⲉ ⲙⲙⲟ ϥ ϣⲁ ϩⲣⲁⲓ ⲉ ⲛ ⲕⲉ ⲣⲣⲱⲟⲩ ⲙ ⲙⲁⲓⲛⲟⲩⲧⲉ	ⲉⲓⲣⲉ	1
ⲡ ⲉⲛⲧ ⲁ ϥ ⲛⲁϩⲙⲉ ⲧ · ⲁⲩⲱ ⲁ ϥ ⲛⲟⲩϫⲉ ⲉⲃⲟⲗ ⲛϩⲏⲧ · ⲙ ⲡ ⲉⲧ ϣⲧⲟⲣⲧⲣ ⲙⲙⲟ ⲓ	ⲡ	1
ⲟⲩ ⲛⲟϭ ⲙ ⲙⲏⲏϣⲉ ⲉⲃⲟⲗ ϩⲛ ⲧ ⲅⲁⲗⲓⲗⲁⲓⲁ	ⲙⲏⲏϣⲉ	1
ⲡ ⲁⲓⲱⲛ	ⲁⲓⲱⲛ	1
ⲙ ⲙⲁ ⲙ ⲡⲉⲧⲣⲁ	ⲙⲁ	1
ⲡ ⲃⲓⲟⲥ	ⲃⲓⲟⲥ	1
ⲡ ⲃⲗⲗⲉ	ⲃⲗⲗⲉ	1
ⲛ ϣⲁϫⲉ ⲛⲓⲙ	ϣⲁϫⲉ	1
ⲥⲧⲉⲫⲁⲛⲁ	ⲥⲧⲉⲫⲁⲛⲁ	1
ⲡ ⲕⲉ ⲥⲙⲟⲩ	ⲥⲙⲟⲩ	1
ⲡ ⲉⲓⲃⲉ	ⲉⲓⲃⲉ	1
ⲡ ⲉⲙⲛⲧ	ⲉⲙⲛⲧ	1
ⲟⲩ ⲥⲟⲟⲩϩⲥ · ⲙ ⲙⲟⲛⲁⲭⲟⲥ ⲛ ⲁⲩⲏⲧ ϩⲛ ⲑⲏⲃⲁⲓⲥ	ⲥⲟⲟⲩϩⲥ	1
ⲡ ⲉⲧ ⲛⲁⲛⲟⲩ ϥ ⲛⲁ ⲩ	ⲡ	1
ⲗⲁⲁⲩ ⲇⲉ ⲛ ϭⲟⲙ	ⲗⲁⲁⲩ	1
ⲧⲟⲩ ϣⲃⲉⲉⲣⲉ	ϣⲃⲉⲉⲣⲉ	1
ⲧ ⲙⲏⲏⲧⲉ ⲛ ⲛⲉ ⲥⲛⲏⲩ	ⲙⲏⲏⲧⲉ	1
ⲙⲟⲟⲩ ⲛ ⲱⲛϩ	ⲙⲟⲟⲩ	1
ⲡ ⲕⲟⲩⲓ	ⲕⲟⲩⲓ	1
ⲟⲩ ⲕⲣⲓⲙⲁ ⲛⲁ ⲛ	ⲕⲣⲓⲙⲁ	1
ⲡⲉϥ ⲭⲣⲓⲥⲧⲟⲥ ⲙⲛ ⲛⲉϥ ⲁⲅⲅⲉⲗⲟⲥ ⲉⲧ ⲟⲩⲁⲁⲃ ⲉⲧ ϥⲓ ϩⲁⲣⲟ ⲛ ϫⲓⲛ ⲧ ⲁⲣⲭⲏ ⲙ ⲡ ⲥⲱⲛⲧ ϣⲁϩⲣⲁⲓ ⲉ ⲡ ϩⲟⲟⲩ ⲛ ϩⲟⲟⲩ ⲁⲩⲱ ⲟⲛ ϣⲁ ⲉⲛⲉϩ	ⲭⲣⲓⲥⲧⲟⲥ	1
ⲡ ⲙⲁⲥⲉ	ⲙⲁⲥⲉ	1
ⲡⲏ ⲉⲧ ⲙⲙⲁⲩ ⲉⲧ ⲕ ϫⲓ ⲙⲙⲟ ϥ ⲛ ϭⲟⲛⲥ	ⲡⲏ	1
ⲡ ⲣⲱϣⲉ	ⲣⲱϣⲉ	1
ⲡ ⲙⲟⲩⲓ	ⲙⲟⲩⲓ	1
ⲛⲁⲓ ⲉⲧⲉⲣⲉ ⲧⲓⲙⲱⲣⲓⲁ ⲛⲓⲙ ϣⲟⲟⲡ ⲛ ⲛ ⲉⲧ ⲉⲓⲣⲉ ⲙⲙⲟ ⲟⲩ	ⲛⲁⲓ	1
ⲛ ⲣⲓⲣ ⲙⲛ ⲧ ⲉϩⲉ ⲛⲧ ⲁ ⲓ ⲕⲟⲛⲥ ⲟⲩ ϩⲛ ⲛ ⲏⲓ ⲛ ⲛ ϩⲉⲗⲗⲏⲛ	ⲣⲓⲣ	1
ⲡ ⲉⲧ ϣⲁⲁⲧ	ⲡ	1
ⲛ ⲉⲛⲧ ⲁ ⲩ ⲟⲩⲁϣ ⲟⲩ	ⲛ	1
ⲡ ⲉⲛⲧ ⲁ ϥ ϫⲟ ϩⲣⲁⲓ ⲛϩⲏⲧ ⲛ ⲛ ⲛⲉϥ ϣⲁϫⲉ	ⲡ	1
ⲡ ⲛⲟⲃⲉ	ⲛⲟⲃⲉ	1
ⲡ ⲉⲧ ϣⲟⲟⲡ	ⲡ	1
ⲡ ⲉⲛⲧ ⲁ ϥ ϯ ⲛⲁ ⲥ ⲛ ⲧⲉϥ ϭⲓϫ · ⲁⲩⲱ ⲁ ϥ ⲧⲟⲩϫⲟ ⲥ ⲉⲃⲟⲗ ϩⲛ ⲁⲙⲛⲧⲉ	ⲡ	1
ⲛ ⲉⲛⲧ ⲁ ⲩ ⲟⲩⲁϩ ⲟⲩ	ⲛ	1
ⲛⲉϥ ⲉⲓⲱⲧ	ⲉⲓⲱⲧ	1
ⲡ ⲉⲧ ϩⲟⲗϭ	ⲡ	1
ⲡ ⲉⲧ ϩⲟⲃⲥ	ⲡ	1
ϩⲉⲛ ⲛⲩⲕⲧⲉⲣⲓⲥ ⲉⲧⲉ ϭⲓⲛϭⲗⲱ ⲡⲉ	ⲛⲩⲕⲧⲉⲣⲓⲥ	1
ⲡ ⲣⲓⲙⲉ	ⲣⲓⲙⲉ	1
ⲡ ⲥⲁⲃⲉ	ⲥⲁⲃⲉ	1
ⲡ ⲥⲁⲓⲛ	ⲥⲁⲓⲛ	1
ⲛⲉⲧⲛ ⲙⲁⲁϫⲉ	ⲙⲁⲁϫⲉ	1
ⲟⲩ ⲣϩⲙⲙⲉ	ⲣϩⲙⲙⲉ	1
ⲡ ⲥⲱⲧⲙ	ⲥⲱⲧⲙ	1
ⲡ ⲧⲃⲃⲟ	ⲧⲃⲃⲟ	1
ⲧⲉⲛ ϩⲩⲡⲟⲙⲟⲛⲏ	ϩⲩⲡⲟⲙⲟⲛⲏ	1
ⲡ ⲉⲧ ϯⲥⲃⲱ	ⲡ	1
ⲡ ⲧⲱⲣⲡ	ⲧⲱⲣⲡ	1
ⲧⲉ ⲕⲗⲟⲟⲗⲉ	ⲕⲗⲟⲟⲗⲉ	1
ⲣⲱⲙⲉ ⲉ ⲓ ⲥⲟⲟⲩⲛ ⲙⲙⲟ ϥ	ⲣⲱⲙⲉ	1
ⲛⲉϥ ⲟⲃϩⲉ	ⲟⲃϩⲉ	1
ⲟⲩ ⲙⲛⲧϣⲁⲛϩⲧⲏϥ	ⲙⲛⲧϣⲁⲛϩⲧⲏϥ	1
ⲡ ⲉⲛⲧ ⲁ ϥ ⲧⲣⲉ ⲡ ϭⲱⲛⲧ · ⲏ ⲡ ⲉⲓⲱⲣϩ ⲛ ⲛⲉ ϩⲓⲟⲙⲉ ϣⲱⲡⲉ ⲛⲁ ⲓ ⲛ ⲃⲟⲧⲉ	ⲡ	1
ⲡⲉ ⲑⲁⲃ ⲛ ⲛⲉ ⲫⲁⲣⲓⲥⲥⲁⲓⲟⲥ	ⲑⲁⲃ	1
ⲟⲩⲱⲛϩ ⲉⲃⲟⲗ	ⲟⲩⲱⲛϩ	1
ⲟⲩ ⲟⲩⲱϣⲙ ⲛ ⲃⲣⲣⲉ	ⲟⲩⲱϣⲙ	1
ⲛⲉϥ ⲛⲟⲃⲉ	ⲛⲟⲃⲉ	1
ⲛ ⲉⲛⲧ ⲁ ⲩ ⲱⲛϩ · ϩⲛ ⲟⲩⲟⲡ	ⲛ	1
ⲧ ⲃⲗⲗⲏ ⲛⲁⲙⲉ ⲉⲧ ϫⲟⲡϫⲡ ⲙ ⲙⲉⲉⲣⲉ ⲛ ⲧ ϩⲉ ⲛ ⲛ ⲉⲧ ϩⲛ ⲧ ⲡⲁϣⲉ ⲛ ⲧⲉ ⲩϣⲏ · ⲁⲩⲱ ⲛ ⲧ ϩⲉ ⲛ ⲛⲓ ⲃⲗⲗⲉ , ⲉⲧⲉ ⲙⲛ ⲃⲁⲗ ⲙⲙⲟ ⲟⲩ	ⲃⲗⲗⲏ	1
ⲛ ⲉⲛⲧ ⲁ ⲛ ⲧⲥⲁⲃⲟ ⲉⲣⲟ ⲟⲩ	ⲛ	1
ⲥⲟⲟⲩ ⲛ ⲉⲃⲟⲧ	ⲉⲃⲟⲧ	1
ⲛ ⲕⲉ ⲟⲩⲱϣ ⲧⲏⲣ ⲟⲩ ⲉⲧ ϣⲟⲩⲉⲓⲧ	ⲟⲩⲱϣ	1
ⲡ ϩⲱⲃ ⲙ ⲡ ⲣⲉϥⲧⲁϣⲉⲟⲉⲓϣ	ϩⲱⲃ	1
ⲛⲉϥ ⲣⲱⲙⲉ	ⲣⲱⲙⲉ	1
ⲛⲉϥ ⲥⲱⲛⲉ	ⲥⲱⲛⲉ	1
ⲧ ⲡⲏⲅⲏ ⲙ ⲙⲟⲟⲩ ⲛ ⲱⲛϩ	ⲡⲏⲅⲏ	1
ⲙⲏⲧⲉ ⲛ ⲣⲟⲙⲡⲉ	ⲣⲟⲙⲡⲉ	1
ⲡⲉⲓ ⲇⲓⲁⲧⲁⲅⲙⲁ	ⲇⲓⲁⲧⲁⲅⲙⲁ	1
ⲟⲩ ⲁⲧϭⲟⲙ	ⲁⲧϭⲟⲙ	1
ⲓⲏⲥⲟⲩⲥ ⲡ ϣⲏⲣⲉ ⲙ ⲡ ⲛⲟⲩⲧⲉ ⲉⲧ ϫⲟⲥⲉ	ⲓⲏⲥⲟⲩⲥ	1
ⲧ ⲕⲁⲑⲟⲗⲓⲕⲏ ⲉⲕⲕⲗⲏⲥⲓⲁ	ⲉⲕⲕⲗⲏⲥⲓⲁ	1
ⲡ ⲉⲧ ⲙⲟⲧⲛ ⲉ ϫⲟⲟ ⲥ ⲙ ⲡ ⲉⲧ ⲥⲏϭ	ⲡ	1
ⲕⲣⲟⲛⲟⲥ	ⲕⲣⲟⲛⲟⲥ	1
ⲛⲉϥ ⲛⲟⲩⲧⲉ ⲛ ϩⲟⲟⲩⲧ ϩⲓ ⲥϩⲓⲙⲉ	ⲛⲟⲩⲧⲉ	1
ⲡ ⲡⲁⲣⲁⲇⲉⲓⲥⲟⲥ	ⲡⲁⲣⲁⲇⲉⲓⲥⲟⲥ	1
ⲛ ⲉⲧ ⲃⲏⲕ	ⲛ	1
ⲛ ⲉⲧ ⲛⲏϫ	ⲛ	1
ⲛ ⲉⲧ ⲥⲏϩ	ⲛ	1
ⲛ ⲉⲧ ⲛⲁⲩ	ⲛ	1
ⲛ ⲉⲧ ⲛⲏⲩ	ⲛ	1
ⲡ ⲕⲉ ϣⲁϫⲉ · ⲉⲧ ⲓ ⲛⲁ ϫⲟⲟ ϥ ⲉⲣⲱ ⲧⲛ	ϣⲁϫⲉ	1
ⲛ ⲉⲧ ⲧⲏⲕ	ⲛ	1
ⲡⲁⲓ ⲉⲛⲧ ⲁ ⲃⲟⲉⲥ ϫⲟⲟ ⲥ ⲉⲧⲃⲏⲏⲧ ϥ	ⲡⲁⲓ	1
ⲧ ⲙⲁⲁⲩ ⲙ ⲡ ϣⲏⲣⲉ ⲉⲧ ⲟⲓ ⲛⲧⲟⲟⲧ ⲥ	ⲙⲁⲁⲩ	1
ⲡ ⲕⲉ ϩⲏⲗⲉⲓⲁⲥ	ϩⲏⲗⲉⲓⲁⲥ	1
ⲛ ⲁⲡⲁⲣⲭⲏ ⲉⲃⲟⲗ ϩⲛ ⲛ ⲕⲁⲣⲡⲟⲥ ⲛ ⲧⲉⲕ ⲇⲓⲕⲁⲓⲟⲥⲩⲛⲏ	ⲁⲡⲁⲣⲭⲏ	1
ⲡⲟⲩ ϩⲁⲓ	ϩⲁⲓ	1
ⲡⲟⲩ ϩⲱⲃ	ϩⲱⲃ	1
ⲛⲉⲛ ⲣⲓⲣ	ⲣⲓⲣ	1
ⲡⲉϥ ⲟⲩϫⲁⲓ	ⲟⲩϫⲁⲓ	1
ⲡ ⲣⲱⲙⲉ ⲛ ⲁⲁⲥ	ⲣⲱⲙⲉ	1
ⲧ ⲙⲛⲧⲧⲉⲗⲓⲟⲥ ⲙ ⲡ ⲣⲱⲙⲉ ⲉⲧ ⲙⲙⲁⲩ ⲙ ⲡ ⲛⲟⲩⲧⲉ · ⲙⲛ ⲛⲉϥ ϣⲁϫⲉ ⲧⲏⲣ ⲟⲩ ⲉⲧⲉ ⲙⲛ ϩⲩⲡⲟⲕⲣⲓⲥⲓⲥ ⲛϩⲏⲧ ⲟⲩ	ⲙⲛⲧⲧⲉⲗⲓⲟⲥ	1
ⲛⲁ ⲟⲓⲕⲟⲛⲟⲙⲟⲥ	ⲟⲓⲕⲟⲛⲟⲙⲟⲥ	1
ⲧⲉ ϩⲣⲱ ⲛ ⲕⲱϩⲧ ⲉⲧ ⲙⲟⲩϩ	ϩⲣⲱ	1
ⲡⲉⲕ ϯ	ϯ	1
ⲛ ⲟⲩⲟⲟⲧⲉ ⲧⲏⲣ ⲟⲩ	ⲟⲩⲟⲟⲧⲉ	1
ⲛⲉ ⲣⲣⲱⲟⲩ	ⲣⲣⲱⲟⲩ	1
ⲧⲉ ϩⲣⲱⲙⲁⲛⲓⲁ	ϩⲣⲱⲙⲁⲛⲓⲁ	1
ⲛⲉ ⲙⲡⲟ	ⲙⲡⲟ	1
ⲛ ⲇⲓⲕⲁⲓⲟⲥⲩⲛⲏ	ⲇⲓⲕⲁⲓⲟⲥⲩⲛⲏ	1
ⲁϣ ϭⲉ ⲛ ⲭⲱⲣⲁ	ⲁϣ	1
ⲟⲩ ⲥϩⲓⲙⲉ	ⲥϩⲓⲙⲉ	1
ⲡ ⲉⲓⲱⲣϩ ⲛ ⲛⲉ ϩⲓⲟⲙⲉ	ⲉⲓⲱⲣϩ	1
ϩⲉⲛ ϩⲃⲏⲩⲉ ⲉ ⲙⲉϣϣⲉ	ϩⲃⲏⲩⲉ	1
ϩⲉⲛ ⲥⲓⲟⲟⲩⲛⲉ	ⲥⲓⲟⲟⲩⲛⲉ	1
ⲡ ⲉⲧ ⲡⲓⲥⲧⲉⲩⲉ	ⲡ	1
ϩⲉⲛ ⲙⲁⲉⲓⲛ	ⲙⲁⲉⲓⲛ	1
ⲧⲉϥ ⲉⲕⲕⲗⲏⲥⲓⲁ	ⲉⲕⲕⲗⲏⲥⲓⲁ	1
ⲛ ⲉⲧⲉ ⲟⲩⲛⲧⲁ ⲩ ⲡ ⲉⲟⲟⲩ ⲙⲛ ⲡ ⲧⲁⲉⲓⲟ ⲉⲃⲟⲗ ϩⲓⲧⲛ ⲓⲏⲥⲟⲩⲥ	ⲛ	1
ⲛ ⲉⲧ ⲉⲓⲣⲉ ⲛ ⲧ ⲁⲛⲟⲙⲓⲁ ϩⲛ ⲟⲩ ϩⲱⲡ ⲏ ϩⲛ ⲟⲩⲱⲛϩ ⲉⲃⲟⲗ ϩⲣⲁⲓ ⲛϩⲏⲧ ⲛ	ⲛ	1
ⲟⲩ ⲡⲣⲟⲫⲁⲥⲓⲥ ⲙ ⲙⲛⲧⲣⲙϩⲉ ⲙ ⲙⲉ	ⲡⲣⲟⲫⲁⲥⲓⲥ	1
ⲛ ⲕⲉ ⲉⲡⲓⲑⲩⲙⲓⲁ ⲉⲧ ⲃⲏⲕ ⲉϩⲟⲩⲛ ⲉⲣⲟ ⲟⲩ	ⲉⲡⲓⲑⲩⲙⲓⲁ	1
ⲛ ⲗⲁⲕⲙ . ⲉⲛⲧ ⲁ ⲩ ⲣϩⲟⲩⲟ	ⲗⲁⲕⲙ	1
ⲧⲉϥ ⲕⲉ ⲟⲩⲥⲓⲁ ⲧⲏⲣ ⲥ	ⲟⲩⲥⲓⲁ	1
ⲡⲁ ⲙⲉⲣⲓⲧ ⲛ ⲉⲓⲱⲧ ⲁⲡⲁ ⲡⲁⲙⲟⲩⲛ · ⲡⲁ ⲙ ⲡⲟⲣⲕ ⲕⲩⲣⲓⲟⲥ	ⲡⲁⲙⲟⲩⲛ	1
ⲧⲉϥ ϣⲧⲏⲛ ⲙ ⲡ ⲃⲟⲗ ⲛ ⲧⲉϥ ⲣⲓ	ϣⲧⲏⲛ	1
ⲡⲉ ⲡⲛⲉⲩⲙⲁ ⲛ ⲧ ⲙⲛⲧϩⲏⲕⲉ	ⲡⲛⲉⲩⲙⲁ	1
ⲡ ⲃⲁⲣⲃⲁⲣⲟⲥ	ⲃⲁⲣⲃⲁⲣⲟⲥ	1
ⲕⲉ ⲉⲓⲱϩⲉ ⲛ ϣⲙⲙⲟ	ⲉⲓⲱϩⲉ	1
ⲡ ⲉⲧⲉ ⲩⲛⲧⲁ ϥ	ⲡ	1
ⲧ ⲡⲟⲗⲓⲧⲉⲓⲁ ⲙ ⲡⲉⲛ ⲡⲉⲧⲟⲩⲁⲁⲃ ⲛ ⲉⲓⲱⲧ ⲉⲧ ⲧⲁⲓⲏⲩ ⲕⲁⲧⲁ ⲥⲙⲟⲧ ⲛⲓⲙ ⲁⲡⲁ ⲟⲛⲛⲟⲫⲣⲓⲟⲥ ⲡ ⲁⲛⲁⲭⲱⲣⲓⲧⲏⲥ ⲛⲧ ⲁ ϥ ϫⲱⲕ ⲉⲃⲟⲗ ⲙ ⲡⲉϥ ⲃⲓⲟⲥ ⲛ ⲥⲟⲩⲙⲛⲧⲧⲁⲥⲉ ⲙ ⲡ ⲉⲃⲟⲧ ⲡⲁⲱⲛⲉ ϩⲛ ⲟⲩ ⲉⲓⲣⲏⲛⲏ ⲛⲧⲉ ⲡ ⲛⲟⲩⲧⲉ	ⲡⲟⲗⲓⲧⲉⲓⲁ	1
ⲧⲉⲛ ⲙⲁⲁⲩ ⲉⲛⲧ ⲁ ⲩ ϫⲡⲟ ⲛ	ⲙⲁⲁⲩ	1
ⲡⲉⲕ ⲙⲧⲟ ⲉⲃⲟⲗ	ⲙⲧⲟ	1
ϩⲉⲛ ϯⲥⲃⲱ ⲙ ⲡⲛⲉⲩⲙⲁ	ϯⲥⲃⲱ	1
ⲡ ⲣⲁⲛ ⲙ ⲡⲉⲛ ϫⲟⲉⲓⲥ ⲓⲏⲥⲟⲩⲥ	ⲣⲁⲛ	1
ⲛ ⲣⲱⲙⲉ ⲙ ⲡ ⲁⲣⲭⲓⲥⲩⲛⲁⲅⲱⲅⲟⲥ	ⲣⲱⲙⲉ	1
ⲥⲁϣϥ ⲛ ϣⲉ ⲙⲁⲁⲃ	ⲙⲁⲁⲃ	1
ϣⲏⲣⲉ ⲙ ⲡ ⲟⲩⲟⲉⲓⲛ	ϣⲏⲣⲉ	1
ⲡ ⲕⲉ ⲧⲃⲧ ⲥⲛⲁⲩ	ⲧⲃⲧ	1
ⲟⲩ ⲇⲁⲓⲙⲱⲛ ϩⲓⲱⲱ ϥ	ⲇⲁⲓⲙⲱⲛ	1
ϩⲉⲛ ϣⲁϫⲉ ⲛ ⲟⲥⲉ	ϣⲁϫⲉ	1
ⲛⲉⲧⲛ ⲏⲣⲡ ⲉⲧ ⲗⲟⲙⲥ	ⲏⲣⲡ	1
ⲡ ⲉⲛⲧ ⲁ ϥ ⲥⲟⲃⲧⲉ ⲛ ⲧⲁ ϭⲓⲛⲃⲱⲕ ϣⲁⲣⲟ ϥ ⲉ ⲥ ⲟⲩⲁⲁⲃ	ⲡ	1
ⲛ ⲉⲫⲣⲁⲑⲁ	ⲉⲫⲣⲁⲑⲁ	1
ⲛⲉ ⲥⲕⲉⲩⲏ	ⲥⲕⲉⲩⲏ	1
ⲥⲁ ⲛⲓⲙ	ⲥⲁ	1
ⲧ ⲙⲛⲧⲁⲧⲥⲟⲟⲩⲛ ⲉⲧ ϣⲟⲟⲡ ⲛϩⲏⲧ ⲛ ⲉⲧⲃⲉ ⲡⲉⲛ ⲧⲱⲛ ⲛ ϩⲏⲧ	ⲙⲛⲧⲁⲧⲥⲟⲟⲩⲛ	1
ⲧⲉ ⲭⲁⲣⲓⲥ	ⲭⲁⲣⲓⲥ	1
ⲟⲩⲁ ⲛ ⲛⲉ ⲥⲛⲏⲩ	ⲟⲩⲁ	1
ⲡ ⲙⲉⲉⲩⲉ ⲛ ⲛ ⲉⲛⲧⲟⲗⲏ ⲙ ⲡ ⲛⲟⲩⲧⲉ	ⲙⲉⲉⲩⲉ	1
ⲛⲉϥ ⲡⲉⲧⲟⲩⲁⲁⲃ	ⲡⲉⲧⲟⲩⲁⲁⲃ	1
ϩⲉⲛ ϣⲁϫⲉ ϩⲓⲃⲟⲗ	ϣⲁϫⲉ	1
ⲟⲩ ϩⲗⲗⲟ ⲇⲉ ⲛ ⲁⲛⲁⲭⲱⲣⲏⲧⲏⲥ	ϩⲗⲗⲟ	1
ⲙ ⲫⲟⲛⲟⲥ	ⲫⲟⲛⲟⲥ	1
ⲡ ⲣⲟⲟⲩϣ ⲛ ⲟⲩ ϣⲱϣ ⲙⲛ ⲟⲩ ⲇⲓⲕⲁⲓⲟⲛ	ⲣⲟⲟⲩϣ	1
ⲁⲡⲁ ϩⲓⲉⲣⲁⲝ	ϩⲓⲉⲣⲁⲝ	1
ϩⲉⲛ ⲕⲉ ϩⲏⲕⲉ	ϩⲏⲕⲉ	1
ⲛ ⲕⲱⲙⲏ ⲛ ⲧ ⲕⲉⲥⲁⲣⲓⲁ ⲛⲧⲉ ⲫⲓⲗⲓⲡⲡⲟⲥ	ⲕⲱⲙⲏ	1
ⲟⲩ ⲕⲁϩ ⲙ ⲙⲉⲗϩ	ⲕⲁϩ	1
ⲟⲩ ⲙⲛⲧⲣⲉϥϯⲕⲁⲣⲡⲟⲥ ⲛ ⲇⲓⲕⲁⲓⲟⲛ · ⲁⲩⲱ ⲙ ⲙⲁⲓⲣⲱⲙⲉ ⲉⲃⲟⲗ ϩⲓⲧⲟⲟⲧ ⲛ ⲉⲧⲉ ⲛ ⲛⲟⲃⲣⲉ	ⲙⲛⲧⲣⲉϥϯⲕⲁⲣⲡⲟⲥ	1
ⲕⲉ ⲥⲡⲏⲗⲁⲓⲟⲛ	ⲥⲡⲏⲗⲁⲓⲟⲛ	1
ⲛ ⲉⲧ ϯ ⲁⲛ ⲉⲧ ⲣⲟⲟⲩⲧ ⲉϩⲟⲩⲛ ⲉ ⲛ ϩⲏⲕⲉ	ⲛ	1
ⲛⲁⲓ ⲧⲏⲣ ⲟⲩ ⲉⲧ ϩⲟⲟⲩ	ⲛⲁⲓ	1
ⲛ ⲉⲧ ϩⲙ ⲡ ⲁⲏⲣ	ⲛ	1
ⲡⲓ ϩⲏⲧ ⲛ ⲟⲩⲱⲧ	ϩⲏⲧ	1
ⲛⲉⲩ ϩⲏⲧ	ϩⲏⲧ	1
ⲟⲩⲟⲛ ⲇⲉ ⲛⲓⲙ ϩⲣⲁⲓ ⲛϩⲏⲧ ⲛ ⲉⲧ ⲛⲁ ⲛⲁⲩ ⲉ ⲩ ϩⲱⲃ ⲛ ⲕⲣⲟϥ	ⲟⲩⲟⲛ	1
ⲡ ⲕⲁⲣⲡⲟⲥ ⲅⲁⲣ ⲙ ⲡ ⲟⲩⲟⲉⲓⲛ	ⲕⲁⲣⲡⲟⲥ	1
ⲛ ⲣⲱⲙⲉ ⲉⲧⲉⲣⲉ ϯⲥⲙⲏ ⲁⲡⲉⲓⲗⲉⲓ ⲉⲣⲱ ⲧⲛ	ⲣⲱⲙⲉ	1
ϩⲉⲛ ⲛⲟϭ ⲛ ⲧⲉⲗⲓⲟⲥ	ⲧⲉⲗⲓⲟⲥ	1
ⲙ ⲙⲏⲏϣⲉ ⲧⲏⲣ ⲟⲩ	ⲙⲏⲏϣⲉ	1
ⲡ ⲣⲁⲛ ⲛ ⲧⲉϥ ⲥϩⲓⲙⲉ	ⲣⲁⲛ	1
ⲣⲛⲧ ⲕ	ⲣⲛⲧ	1
ⲡⲁⲓ ⲉⲧ ⲛⲁ ⲧⲁϫⲣⲉ ⲧⲏⲩⲧⲛ	ⲡⲁⲓ	1
ⲛⲉⲕ ϩⲓⲥⲉ	ϩⲓⲥⲉ	1
ⲩ ⲙⲛⲧⲙⲛⲧⲣⲉ ⲛⲁ ⲩ	ⲙⲛⲧⲙⲛⲧⲣⲉ	1
ⲡ ϩⲏⲧ ⲙ ⲡ ⲛⲟⲩⲧⲉ	ϩⲏⲧ	1
ⲟⲩ ⲃⲁⲗ ⲉ ϥ ϩⲟⲟⲩ	ⲃⲁⲗ	1
ⲑⲉⲟⲇⲱⲥⲓⲟⲥ ⲡ ⲣⲣⲟ	ⲑⲉⲟⲇⲱⲥⲓⲟⲥ	1
ⲧ ⲙⲉϩϣⲟⲙⲧⲉ ⲛ ⲣⲟⲙⲡⲉ ⲛ ⲧⲉϥ ⲙⲛⲧⲣⲣⲟ	ⲣⲟⲙⲡⲉ	1
ⲡ ⲉⲓⲇⲟⲥ	ⲉⲓⲇⲟⲥ	1
ⲛ ⲉⲧⲉ ⲙⲉϣϣⲉ ⲙ ⲡ ⲙⲧⲟ ⲉⲃⲟⲗ ⲙ ⲡ ⲛⲟⲩⲧⲉ ⲓⲏⲥⲟⲩⲥ ⲡⲉ ⲭⲣⲓⲥⲧⲟⲥ	ⲛ	1
ⲡ ⲁⲣⲓⲥⲧⲟⲛ ⲉⲧ ⲛⲧⲟⲟⲧ ϥ	ⲁⲣⲓⲥⲧⲟⲛ	1
ⲟⲩ ϩⲟⲣⲟⲙⲁ	ϩⲟⲣⲟⲙⲁ	1
ⲛ ⲉⲧ ⲟⲩ ϯ ⲙⲙⲟ ⲟⲩ	ⲛ	1
ⲡ ⲉⲧ ⲛⲁ ϫⲟⲟ ⲥ ⲛϩⲏⲧ ⲟⲩ ⲁⲛⲅ ⲟⲩ ⲭⲣⲓⲥϯⲁⲛⲟⲥ	ⲡ	1
ⲛⲉⲧⲛ ⲡⲟⲛⲏⲣⲓⲁ	ⲡⲟⲛⲏⲣⲓⲁ	1
ⲓⲏⲥⲟⲩⲥ ⲙⲁⲩⲁⲁ ϥ	ⲓⲏⲥⲟⲩⲥ	1
ⲡⲉϥ ⲥⲱⲙⲁ ⲧⲏⲣ ϥ	ⲥⲱⲙⲁ	1
ⲟⲩ ⲁⲗ ⲛ ⲙⲡⲟ	ⲁⲗ	1
ⲡⲉϥ ⲙⲉⲉⲩⲉ ⲙ ⲙⲛⲧⲕⲱⲥⲙⲓⲕⲟⲛ	ⲙⲉⲉⲩⲉ	1
ⲡ ⲉⲧ ⲣⲟⲉⲓⲥ ⲁⲩⲱ ⲉⲧ ϩⲁⲣⲉϩ ⲉ ⲡⲉϥ ϩⲓⲥⲉ ⲛⲁ ϥ	ⲡ	1
ⲙⲛⲧⲥⲛⲟⲟⲩⲥ	ⲙⲛⲧⲥⲛⲟⲟⲩⲥ	1
ⲛ ϣⲏⲣⲉ ⲙ ⲡ ⲕⲁⲕⲉ ⲉⲧⲉ ⲛ ⲉⲧ ⲙⲟⲟϣⲉ ⲛⲉ ϩⲛ ⲙⲛⲧⲁⲧⲥⲱⲧⲙ ⲛⲓⲙ ϩⲓ ⲙⲛⲧⲁⲧⲥⲃⲱ ⲛⲓⲙ	ϣⲏⲣⲉ	1
ⲓⲏⲥⲟⲩⲥ ⲡ ⲉⲛⲧ ⲁ ϥ ϣⲱⲛⲧ ⲙ ⲡⲉ ⲕⲗⲟⲙ ⲡⲁⲓ ⲉⲧ ϩⲙ ⲡⲉⲕ ϣⲱⲛⲧ ⲡⲱⲕ	ⲓⲏⲥⲟⲩⲥ	1
ⲧ ⲗⲓⲧⲟⲩⲣⲅⲓⲁ ⲧⲉ ⲉⲃⲟⲗ ϩⲓⲧⲛ ⲛⲉ ⲭⲣⲏⲙⲁ	ⲗⲓⲧⲟⲩⲣⲅⲓⲁ	1
ϩⲣⲉⲃⲉⲕⲕⲁ ⲧ ⲙⲁⲁⲩ ⲛ ⲓⲁⲕⲱⲃ	ϩⲣⲉⲃⲉⲕⲕⲁ	1
ⲧ ⲡⲁⲣⲁⲃⲟⲗⲏ	ⲡⲁⲣⲁⲃⲟⲗⲏ	1
ⲛⲓ ϯⲧⲱⲛ ⲉ ⲡ ϫⲓⲛϫⲏ	ϯⲧⲱⲛ	1
ⲛ ϩⲟⲉⲓⲙ	ϩⲟⲉⲓⲙ	1
ⲛ ⲕⲁⲣⲡⲟⲥ ⲛ ⲧⲉⲕ ⲇⲓⲕⲁⲓⲟⲥⲩⲛⲏ	ⲕⲁⲣⲡⲟⲥ	1
ⲛ ϩⲟⲟⲩⲧ	ϩⲟⲟⲩⲧ	1
ⲡⲉⲛ ⲕⲁⲣⲱϥ	ⲕⲁⲣⲱϥ	1
ⲛ ϩⲁⲗⲁⲧⲉ ⲛ ⲧ ⲡⲉ	ϩⲁⲗⲁⲧⲉ	1
ⲛ ϣⲏⲣⲉ ⲛ ⲟⲩ ⲣⲱⲙⲉ ⲛ ⲟⲩⲱⲧ ⲉⲧⲉ ⲡ ⲛⲟⲩⲧⲉ ⲡⲉ	ϣⲏⲣⲉ	1
ⲡ ⲕⲉ ϩⲱⲃ ⲛ ⲛⲉⲛ ϭⲓϫ	ϩⲱⲃ	1
ⲧⲉ ⲧⲣⲁⲡⲉⲍⲁ ⲛ ⲛ ϣⲏⲣⲉ	ⲧⲣⲁⲡⲉⲍⲁ	1
ⲧ ⲙⲏⲧⲉ ⲛ ϩⲉⲛ ⲟⲩⲱⲛϣ	ⲙⲏⲧⲉ	1
ⲡⲉⲛ ⲟⲩϫⲁⲓ	ⲟⲩϫⲁⲓ	1
ⲡ ⲙⲁ ⲛ ⲧ ⲡⲟⲛⲏⲣⲓⲁ ⲙ ⲡ ⲡⲟⲛⲏⲣⲟⲥ ⲛ ⲣⲱⲙⲉ	ⲙⲁ	1
ⲟⲩⲁ ⲡⲉ ⲛ ⲛⲉ ⲡⲣⲟⲫⲏⲧⲏⲥ	ⲟⲩⲁ	1
ⲧⲉ ⲫⲩⲗⲏ ⲅⲁⲣ ⲧⲏⲣ ⲥ ⲙ ⲡ ⲗⲁⲟⲥ	ⲫⲩⲗⲏ	1
ⲛⲉⲥ ⲣⲙⲣⲁⲩⲏ	ⲣⲙⲣⲁⲩⲏ	1
ⲡ ⲙⲁ ⲛ ⲣⲙⲏ	ⲙⲁ	1
ⲟⲩ ⲥⲡⲉⲕⲟⲩⲗⲁⲧⲱⲣ	ⲥⲡⲉⲕⲟⲩⲗⲁⲧⲱⲣ	1
ⲛ ⲉⲧ ⲥⲁϩⲟⲩ ⲙⲙⲟ ϥ ⲉⲧ ⲣⲛⲟⲃⲉ ⲉⲣⲟ ϥ	ⲛ	1
ⲙ ⲡⲟⲣⲛⲟⲥ ⲙ ⲡⲉⲓ ⲕⲟⲥⲙⲟⲥ	ⲡⲟⲣⲛⲟⲥ	1
ⲛ ⲉⲛⲧ ⲁ ⲩ ⲙⲟⲩ ⲅⲁⲣ ϩⲙ ⲡ ϩⲟϫϩϫ ⲛ ⲙ ⲙⲏⲏϣⲉ	ⲛ	1
ⲧⲁ ⲙⲛⲧⲁⲧⲛⲁϩⲧⲉ	ⲙⲛⲧⲁⲧⲛⲁϩⲧⲉ	1
ϩⲉⲛ ⲭⲁⲣⲓⲥⲙⲁ ⲛ ⲇⲱⲣⲟⲛ	ⲭⲁⲣⲓⲥⲙⲁ	1
ⲛⲉⲓ ⲑⲗⲓⲯⲓⲥ ⲛ ⲟⲩⲱⲧ	ⲑⲗⲓⲯⲓⲥ	1
ⲡ ⲉⲛⲧ ⲁ ϥ ⲕⲁ ⲛⲁ ⲙⲉⲉⲩⲉ ⲉ ⲩ ϣⲟⲟⲡ ⲉϩⲟⲩⲛ ⲉⲣⲟ ϥ ⲛ ⲁⲧⲧⲱⲗⲙ	ⲡ	1
ⲟⲩ ⲙⲕⲁϩ ⲛ ϩⲏⲧ ⲉ ⲛⲁϣⲱ ϥ	ⲙⲕⲁϩ	1
ⲁⲡⲁ ⲡⲁⲙⲃⲱ ⲡⲉ ⲡⲣⲉⲥⲃⲩⲧⲉⲣⲟⲥ ⲛ ⲧ ⲉⲕⲕⲗⲏⲥⲓⲁ · ⲛ ϣⲓⲏⲧ ⲁⲩⲱ ⲡ ⲛⲟϭ ⲛ ϫⲟⲓ ⲉⲧ ⲣϩⲱⲧ ϩⲙ ⲡ ϫⲁⲓⲉ ⲛ ⲁⲧⲙⲟⲟⲩ ·	ⲡⲁⲙⲃⲱ	1
ϩⲟⲓⲛⲉ ⲛ ⲛ ⲉⲧ ⲁϩⲉ ⲣⲁⲧ ⲟⲩ ⲙ ⲡⲉⲓ ⲙⲁ ⲉ ⲛ ⲥⲉ ⲛⲁ ϫⲓϯⲡⲉ ⲁⲛ ⲙ ⲡ ⲙⲟⲩ ϣⲁⲛⲧ ⲟⲩ ⲛⲁⲩ ⲉ ⲧ ⲙⲛⲧⲣⲣⲟ ⲙ ⲡ ⲛⲟⲩⲧⲉ ⲉ ⲁ ⲥ ⲉⲓ ϩⲛ ⲟⲩ ϭⲟⲙ	ϩⲟⲓⲛⲉ	1
ⲙ ⲙⲉⲉⲩⲉ ⲧⲏⲣ ⲟⲩ ⲙ ⲡ ⲇⲓⲁⲃⲟⲗⲟⲥ ⲉⲧ ϥ ⲛⲟⲩϫⲉ ⲙⲙⲟ ⲟⲩ ⲉϩⲟⲩⲛ ⲉⲣⲟ ⲛ	ⲙⲉⲉⲩⲉ	1
ⲧⲉϥ ϣⲉⲉⲣⲉ	ϣⲉⲉⲣⲉ	1
ⲧ ⲙⲛⲧⲥⲩⲛⲕⲗⲏⲧⲓⲕⲟⲥ	ⲙⲛⲧⲥⲩⲛⲕⲗⲏⲧⲓⲕⲟⲥ	1
ϩⲱⲃ ⲛⲓⲙ ⲉⲧⲉ ⲣ ⲁ ϫⲟⲟ ⲩ	ϩⲱⲃ	1
ⲡ ϣⲁϫⲉ ⲉⲛⲧ ⲁ ⲩ ϫⲟ ϥ ⲛϩⲏⲧ ⲟⲩ	ϣⲁϫⲉ	1
ⲡⲁ ⲡⲁⲩⲗⲟⲥ	ⲡⲁⲩⲗⲟⲥ	1
ⲟⲩ ⲙⲟⲩ	ⲙⲟⲩ	1
ⲟⲩ ⲟⲥⲉ	ⲟⲥⲉ	1
ⲟⲩ ⲥⲃⲱ	ⲥⲃⲱ	1
ⲟⲩ ⲥⲙⲏ	ⲥⲙⲏ	1
ⲟⲩ ⲥⲟⲡ	ⲥⲟⲡ	1
ⲡ ⲙⲁ ⲉ ϣⲁ ⲩ ⲥⲱⲧⲙ	ⲙⲁ	1
ⲡⲉⲕ ϣⲟⲩϣⲟⲩ	ϣⲟⲩϣⲟⲩ	1
ⲡ ⲉⲛⲧ ⲁ ϥ ⲥⲟⲩⲱⲛ ⲉ	ⲡ	1
ⲛⲏ ⲇⲉ ⲉⲧ ϩⲓⲃⲟⲗ	ⲛⲏ	1
ⲡ ⲛⲟϭ ⲙ ⲡⲁⲥⲭⲁ ⲉⲧ ⲟⲩⲁⲁⲃ ⲉⲧⲉⲣⲉ ⲟⲩⲟⲛ ⲛⲓⲙ ⲉⲓⲣⲉ ⲙⲙⲟ ϥ ϣⲁ ϩⲣⲁⲓ ⲉ ⲛ ⲕⲉ ⲣⲣⲱⲟⲩ ⲙ ⲙⲁⲓⲛⲟⲩⲧⲉ	ⲡⲁⲥⲭⲁ	1
ⲡⲉⲛ ⲉⲟⲟⲩ	ⲉⲟⲟⲩ	1
ⲡⲁⲓ ⲅⲉⲛⲟⲥ	ⲅⲉⲛⲟⲥ	1
ϩⲟⲉⲓⲧⲉ	ϩⲟⲉⲓⲧⲉ	1
ⲛ ⲉⲧ ⲛⲁ ϣⲱⲡⲉ	ⲛ	1
ⲛ ⲉⲛⲧ ⲁ ⲩ ϫⲓⲧ ⲟⲩ ⲛ ϭⲟⲛⲥ	ⲛ	1
ⲧ ⲥⲟⲫⲓⲁ ⲅⲁⲣ ⲙ ⲡⲉⲓ ⲕⲟⲥⲙⲟⲥ	ⲥⲟⲫⲓⲁ	1
ⲡ ⲉⲛⲧ ⲁ ϥ ϫⲡⲉ ⲁⲣⲉⲧⲏ ⲛⲓⲙ ϩⲓ ⲁⲗⲗⲁ	ⲡ	1
ⲟⲩ ⲙⲛⲧⲣⲉϥⲧⲱϩ	ⲙⲛⲧⲣⲉϥⲧⲱϩ	1
ϩⲉⲛ ⲕⲉ ϩⲛⲁⲁⲩ	ϩⲛⲁⲁⲩ	1
ⲡ ⲛⲟⲩⲧⲉ ⲡⲁⲓ ⲉⲛⲧ ⲁ ϥ ⲧⲉϩⲙ ⲧⲏⲩⲧⲛ ⲉⲃⲟⲗ ϩⲓⲧⲟⲟⲧ ϥ ⲉ ⲧ ⲕⲟⲓⲛⲱⲛⲓⲁ ⲙ ⲡⲉϥ ϣⲏⲣⲉ ⲓⲏⲥⲟⲩⲥ ⲡⲉ ⲭⲣⲓⲥⲧⲟⲥ ⲡⲉⲛ ϫⲟⲉⲓⲥ	ⲛⲟⲩⲧⲉ	1
ⲡⲉ ϩⲟⲟⲩ ⲙ ⲡⲉⲧⲛ ϭⲙ ⲡ ϣⲓⲛⲉ	ϩⲟⲟⲩ	1
ⲡⲁ ⲙⲁ ⲛ ϣⲱⲡⲉ	ⲙⲁ	1
ⲛⲉ ϩⲛⲁⲁⲩ ⲛ ⲧ ⲇⲓⲁⲕⲟⲛⲓⲁ ⲙ ⲡ ⲛⲟⲩⲧⲉ	ϩⲛⲁⲁⲩ	1
ⲡⲉⲛ ⲧⲱⲛ ⲛ ϩⲏⲧ	ⲧⲱⲛ	1
ⲡⲉ ⲥⲙⲟⲧ · ⲛ ⲟⲩ ⲙⲁ ⲉ ϥ ⲡⲟⲣϣ	ⲥⲙⲟⲧ	1
ⲛ ϫⲱⲱⲣⲉ	ϫⲱⲱⲣⲉ	1
ⲛⲉ ϩⲃⲏⲩⲉ ⲙ ⲡⲉ ⲑⲃⲃⲓⲟ ⲛ ϩⲏⲧ	ϩⲃⲏⲩⲉ	1
ⲥⲩⲛⲍⲏⲧⲏⲧⲏⲥ ⲛⲧⲉ ⲡⲉⲓ ⲁⲓⲱⲛ	ⲥⲩⲛⲍⲏⲧⲏⲧⲏⲥ	1
ⲩ ⲣⲱⲙⲉ ⲉ ϥ ϩⲁ ⲉⲟⲟⲩ ⲉⲙⲁⲧⲉ	ⲣⲱⲙⲉ	1
ⲡⲉⲛ ⲧⲃⲃⲟ	ⲧⲃⲃⲟ	1
ϩⲉⲛ ⲟⲩⲱϩⲉ	ⲟⲩⲱϩⲉ	1
ⲧ ⲡⲓⲥⲧⲓⲥ ϩⲱⲱ ⲥ ⲛ ⲧ ⲕⲁⲑⲟⲗⲓⲕⲏ ⲉⲕⲕⲗⲏⲥⲓⲁ	ⲡⲓⲥⲧⲓⲥ	1
ⲛⲉⲓⲙⲓⲥⲗⲏⲥ ⲛ ⲕⲁϩ	ⲛⲉⲓⲙⲓⲥⲗⲏⲥ	1
ⲙⲛⲧⲥⲛⲟⲟⲩⲥ ⲛ ⲗⲟⲟⲩ	ⲗⲟⲟⲩ	1
ⲛⲟⲩ ϩⲃⲏⲩⲉ ⲙ ⲙⲛⲧⲥⲟϭ ⲉ ⲧⲉ ⲉⲓⲣⲉ ⲙⲙⲟ ⲟⲩ	ϩⲃⲏⲩⲉ	1
ⲛ ⲡⲁⲣⲁⲃⲟⲗⲏ	ⲡⲁⲣⲁⲃⲟⲗⲏ	1
ⲟⲩ ⲙⲛⲧⲙⲁⲓⲧⲟ ⲛ ϩⲟⲩⲟ	ⲙⲛⲧⲙⲁⲓⲧⲟ	1
ϩⲉⲛ ⲟⲩⲉϩⲥⲁϩⲛⲉ ⲙⲙⲁⲩ ⲉ ⲛⲁϣⲱ ⲟⲩ	ⲟⲩⲉϩⲥⲁϩⲛⲉ	1
ⲧⲉⲕ ⲡⲣⲟⲥⲫⲟⲣⲁ ⲛ ⲃⲟⲧⲉ	ⲡⲣⲟⲥⲫⲟⲣⲁ	1
ⲧⲁⲓ ⲛⲧ ⲁ ⲩ ⲧⲥⲁⲃⲟ ⲛ ⲉⲣⲟ ⲥ · ⲉⲃⲟⲗ ϩⲓⲧⲟⲟⲧ ⲕ	ⲧⲁⲓ	1
ϩⲉⲛ ⲟⲩⲱⲛϣ	ⲟⲩⲱⲛϣ	1
ⲡⲉ ϩⲣⲟⲟⲩ ⲙ ⲡ ⲉⲧ ⲱϣ ⲉⲃⲟⲗ ϩⲛ ⲧ ⲉⲣⲏⲙⲟⲥ ϫⲉ ⲥⲟⲩⲧⲛ ⲧⲉ ϩⲓⲏ ⲙ ⲡ ϫⲟⲉⲓⲥ ⲛ ⲧⲉⲧⲛ ⲥⲟⲩⲧⲛ ⲛⲉϥ ⲙⲟⲉⲓⲧ	ϩⲣⲟⲟⲩ	1
ⲡ ⲉⲧ ⲙⲟⲟϣⲉ ϩⲛ ⲡⲉ ϩⲟⲟⲩ	ⲡ	1
ⲙⲛⲧⲥⲛⲟⲟⲩⲥ ⲛ ⲣⲱⲙⲉ	ⲣⲱⲙⲉ	1
ⲗⲁⲁⲩ ⲉ ⲁ ⲓ ⲁⲁ ϥ	ⲗⲁⲁⲩ	1
ⲛ ⲕⲉ ⲁⲗ	ⲁⲗ	1
ⲛ ⲕⲉ ⲏⲓ	ⲏⲓ	1
ⲁⲧⲛⲟⲩⲧⲉ	ⲁⲧⲛⲟⲩⲧⲉ	1
ⲣⲱ ϥ ⲙ ⲡ ϣⲱⲛⲉ ⲉⲧ ϩⲏⲡ ⲛ ⲧⲁ ⲯⲩⲭⲏ	ⲣⲱ	1
ⲡ ⲙⲉϩϥⲧⲟⲟⲩ · ⲛ ϩⲟⲟⲩ	ϩⲟⲟⲩ	1
ⲡ ϩⲙϩⲁⲗ ⲇⲉ ⲉⲧ ϩⲓϫⲛ ⲛ ⲉⲧ ⲱϩⲥ	ϩⲙϩⲁⲗ	1
ⲡ ⲛⲟϭⲛⲉϭ ⲛ ⲛ ⲣⲱⲙⲉ	ⲛⲟϭⲛⲉϭ	1
ⲡⲉ ⲕⲣⲟϥ	ⲕⲣⲟϥ	1
ⲛ ⲉⲛⲧ ⲁ ⲓ ⲥⲟⲧⲙ ⲟⲩ ⲧⲏⲣ ⲟⲩ ⲛⲧⲉ ⲡⲁ ⲉⲓⲱⲧ	ⲛ	1
ⲡ ⲉⲟⲟⲩ ⲙ ⲡ ⲛⲟⲩⲧⲉ	ⲉⲟⲟⲩ	1
ⲩ ⲥⲟⲛ ⲉ ϥ ⲣϩⲟⲧⲉ ⲛϩⲏⲧ ϥ ⲙ ⲡ ⲛⲟⲩⲧⲉ	ⲥⲟⲛ	1
ⲡ ⲉⲧⲉ ⲛⲧⲟϥ ⲡⲉ ⲛϩⲏⲧ ⲟⲩ	ⲡ	1
ⲟⲩ ⲉⲝⲟⲩⲥⲓⲁ	ⲉⲝⲟⲩⲥⲓⲁ	1
ⲟⲩ ⲙⲁⲑⲏⲧⲏⲥ ⲛ ⲟⲩ ϫⲱ ⲙ ⲙⲟⲟⲩ	ⲙⲁⲑⲏⲧⲏⲥ	1
ⲙⲁⲓⲧⲟ ⲛ ϩⲟⲩⲟ	ⲙⲁⲓⲧⲟ	1
ⲧⲉ ϣⲡⲏⲣⲉ ⲛⲧ ⲁ ⲥ ϣⲱⲡⲉ ⲙ ⲡ ⲙⲁⲕⲁⲣⲓⲟⲥ ⲛ ⲁⲡⲟⲥⲧⲟⲗⲟⲥ · ⲁⲩⲱ ⲛ ⲉⲩⲁⲅⲅⲉⲗⲓⲥⲧⲏⲥ · ⲁⲩⲱ ⲡ ⲑⲉⲟⲗⲟⲅⲟⲥ · ⲁⲩⲱ ⲡ ⲡⲁⲣⲑⲉⲛⲟⲥ ⲉⲧ ⲟⲩⲁⲁⲃ · ⲡ ϩⲁⲅⲓⲟⲥ ⲓⲱϩⲁⲛⲛⲏⲥ · ⲡ ⲙⲉⲣⲓⲧ ⲙ ⲡⲉ ⲭⲣⲓⲥⲧⲟⲥ ⲓⲏⲥⲟⲩⲥ ⲡⲉⲛ ϫⲟⲉⲓⲥ · ⲁⲩⲱ ⲡⲉⲛ ⲛⲟⲩⲧⲉ · ⲁⲩⲱ ⲡⲉⲛ ⲥⲱⲧⲏⲣ	ϣⲡⲏⲣⲉ	1
ⲟⲩ ⲁⲅⲁⲡⲏ	ⲁⲅⲁⲡⲏ	1
ⲧⲉ ϣⲧⲏⲛ · ⲛ ⲓⲱⲥⲏⲫ ⲡ ⲇⲓⲕⲁⲓⲟⲥ	ϣⲧⲏⲛ	1
ⲟⲩ ⲁϣⲁϩⲟⲙ ⲉⲃⲟⲗ ϩⲛ ϩⲉⲛ ϩⲓⲥⲉ	ⲁϣⲁϩⲟⲙ	1
ⲡ ϫⲟⲉⲓⲥ ⲙ ⲡ ⲉⲟⲟⲩ	ϫⲟⲉⲓⲥ	1
ⲛ ⲓⲟⲩⲇⲁⲓ	ⲓⲟⲩⲇⲁⲓ	1
ⲟⲩ ⲣⲙⲛⲥⲟⲟⲩⲛ ⲛⲧⲉ ⲡⲉⲥ ϩⲁⲓ	ⲣⲙⲛⲥⲟⲟⲩⲛ	1
ⲡⲉ ⲭⲁⲟⲥ	ⲭⲁⲟⲥ	1
ⲙⲏⲧ ⲛ ⲥⲧⲉⲓⲱϩⲉ	ⲥⲧⲉⲓⲱϩⲉ	1
ⲡ ϩⲏⲧ ⲛ ⲛ ⲣⲱⲙⲉ	ϩⲏⲧ	1
ⲧ ⲙⲁⲣⲧⲩⲣⲓⲁ ⲙ ⲡ ϩⲁⲅⲓⲟⲥ ⲃⲓⲕⲧⲱⲣ ⲡⲉ ⲥⲧⲣⲁⲧⲏⲗⲁⲧⲏⲥ ⲁⲩⲱ ⲡ ⲙⲁⲣⲧⲩⲣⲟⲥ ⲉⲧ ⲧⲁⲓⲏⲩ ⲙ ⲡⲉ ⲭⲣⲓⲥⲧⲟⲥ · ⲁⲩⲱ ⲡ ϥⲁⲓⲕⲗⲟⲙ ⲛⲁⲙⲉ · ⲛⲧ ⲁ ϥ ϫⲱⲕ ϫⲉ ⲉⲃⲟⲗ ⲙ ⲡⲉϥ ⲁⲅⲱⲛ ⲉⲧ ⲧⲁⲓⲏⲩ · ⲛ ⲥⲟⲩ ϫⲟⲩⲧⲥⲁϣϥⲉ ⲙ ⲡ ⲉⲃⲟⲧ ⲫⲁⲣⲙⲟⲩⲧⲉ	ⲙⲁⲣⲧⲩⲣⲓⲁ	1
ⲛ ⲁⲣⲉⲧⲏ ⲙ ⲡⲉ ⲑⲃⲃⲓⲟ	ⲁⲣⲉⲧⲏ	1
ϩⲉⲛ ⲡⲟⲗⲓⲥ	ⲡⲟⲗⲓⲥ	1
ⲛⲓ ⲱϩⲉ	ⲱϩⲉ	1
ⲛⲉϥ ⲉⲛⲧⲟⲗⲏ · ⲉⲧ ⲟⲩⲁⲁⲃ	ⲉⲛⲧⲟⲗⲏ	1
ⲡ ⲙⲁ ⲉⲧ ϥ ⲛⲁ ⲧⲁϩⲟ ϥ	ⲙⲁ	1
ϭⲉ ⲗⲁⲁⲩ ⲛ ⲛⲟⲃⲉ	ⲗⲁⲁⲩ	1
ϩⲉⲛ ⲛⲏⲥⲧⲉⲓⲁ	ⲛⲏⲥⲧⲉⲓⲁ	1
ϩⲱⲃ ⲛⲓⲙ ⲉⲧⲉⲣⲉ ⲛ ⲉⲧ ⲟⲩⲁⲁⲃ ⲉⲓⲣⲉ ⲙⲙⲟ ⲟⲩ	ϩⲱⲃ	1
ⲭⲣⲏⲥⲧⲟⲥ	ⲭⲣⲏⲥⲧⲟⲥ	1
ⲟⲩ ⲁⲡⲟⲧ ⲙ ⲙⲟⲟⲩ	ⲁⲡⲟⲧ	1
ϭⲉ ⲗⲁⲁⲩ ⲛ ⲣⲱⲙⲉ	ⲗⲁⲁⲩ	1
ⲡ ⲁⲣⲭⲏⲉⲡⲓⲥⲕⲟⲡⲟⲥ ⲙⲁⲩⲁⲁ ϥ	ⲁⲣⲭⲏⲉⲡⲓⲥⲕⲟⲡⲟⲥ	1
ⲟⲩ ϣⲟⲩⲣⲏ ⲛ ⲛⲟⲩⲃ	ϣⲟⲩⲣⲏ	1
ⲟⲩ ⲁⲧⲟⲩⲱ	ⲁⲧⲟⲩⲱ	1
ⲧⲓⲙⲱⲣⲓⲁ ⲛⲓⲙ	ⲧⲓⲙⲱⲣⲓⲁ	1
ⲛⲉⲩ ⲡⲁⲑⲟⲥ	ⲡⲁⲑⲟⲥ	1
ⲧ ϩⲓⲙⲉ ⲙ ⲡⲉⲕ ⲥⲟⲛ	ϩⲓⲙⲉ	1
ϩⲉⲛ ⲣⲁⲥⲟⲩ	ⲣⲁⲥⲟⲩ	1
ⲛ ⲛⲟⲩⲧⲉ ⲉⲧ ϯ ⲛⲁ ⲛ ⲙ ⲡⲉ ϫⲣⲟ ϩⲙ ⲡ ⲡⲟⲗⲉⲙⲟⲥ	ⲛⲟⲩⲧⲉ	1
ⲃⲁⲥⲕⲁⲛⲟⲥ	ⲃⲁⲥⲕⲁⲛⲟⲥ	1
ⲩ ⲡⲓⲥⲧⲟⲥ	ⲡⲓⲥⲧⲟⲥ	1
ⲡ ϣⲏⲣⲉ ϣⲏⲙ	ϣⲏⲣⲉ	1
ⲡⲉϥ ⲟⲩⲟⲉⲓ	ⲟⲩⲟⲉⲓ	1
ⲟⲩ ⲙⲛⲧⲁⲅⲁⲑⲟⲥ	ⲙⲛⲧⲁⲅⲁⲑⲟⲥ	1
ϭⲉ ⲗⲁⲁⲩ ⲛ ϩⲛⲁⲁⲩ ⲉ ϥ ⲧⲛⲧⲱⲛ ⲉ ⲛⲁⲓ	ⲗⲁⲁⲩ	1
ⲡⲉ ⲡⲣⲟⲥⲟⲡⲟⲛ ⲙ ⲡ ⲛⲟⲩⲧⲉ	ⲡⲣⲟⲥⲟⲡⲟⲛ	1
ⲡ ⲙⲁ ⲉⲧⲉⲣⲉ ⲡ ϩⲙϩⲁⲗ ⲙ ⲡ ⲛⲟⲩⲧⲉ ⲛϩⲏⲧ ϥ	ⲙⲁ	1
ⲡ ⲟⲩⲱϣ ⲛ ⲓⲏⲥⲟⲩⲥ	ⲟⲩⲱϣ	1
ⲙⲛⲧⲯⲓⲧⲉ ⲛ ⲣⲟⲙⲡⲉ	ⲣⲟⲙⲡⲉ	1
ϩⲉⲛ ⲣⲱⲙⲉ ⲙ ⲡⲓⲥⲧⲟⲥ	ⲣⲱⲙⲉ	1
ⲛⲟⲩ ϣⲁϫⲉ	ϣⲁϫⲉ	1
ⲡ ⲙⲉⲉⲩⲉ ⲗⲟⲓⲡⲟⲛ ⲙ ⲡ ϣⲁϫⲉ · ⲛⲧ ⲁ ⲡ ϫⲟⲉⲓⲥ ϫⲟⲟ ϥ ⲙ ⲡⲉⲧⲣⲟⲥ	ⲙⲉⲉⲩⲉ	1
ⲡⲉⲩ ϩⲣⲟⲟⲩ	ϩⲣⲟⲟⲩ	1
ⲧⲓⲟⲩ ⲛ ⲟⲉⲓⲕ	ⲟⲉⲓⲕ	1
ⲧ ⲉⲛⲧ ⲁ ⲥ ⲥⲓϣⲉ	ⲧ	1
ⲡⲉⲓ ϣⲁϫⲉ	ϣⲁϫⲉ	1
ⲧ ⲕⲟⲗⲁⲥⲓⲥ	ⲕⲟⲗⲁⲥⲓⲥ	1
ⲧⲉⲓ ϩⲃⲥⲱ ⲛ ⲟⲩⲱⲧ ⲧ ⲉⲧ ⲓ ϭⲓⲛⲉ ⲛ ⲧⲁ ϩⲙⲙⲉ ⲛϩⲏⲧ ⲥ · ⲛ ⲧⲉ ⲡⲣⲱ	ϩⲃⲥⲱ	1
ⲟⲩ ⲛⲟϭ ⲛ ϣⲡⲏⲣⲉ	ϣⲡⲏⲣⲉ	1
ⲟⲩ ϫⲁϫⲉ ⲉⲧⲃⲉ ⲡ ⲛⲟⲩⲧⲉ	ϫⲁϫⲉ	1
ⲡⲉⲛ ⲛⲟⲩⲧⲉ	ⲛⲟⲩⲧⲉ	1
ⲟⲩ ϩⲟⲟⲩ ⲛ ⲟⲩⲱⲧ	ϩⲟⲟⲩ	1
ⲙⲛⲧⲏ ⲛ ⲣⲟⲙⲡⲉ	ⲣⲟⲙⲡⲉ	1
ϩⲉⲛ ⲡⲟⲛⲏⲣⲓⲁ	ⲡⲟⲛⲏⲣⲓⲁ	1
ϩⲉⲛ ⲡⲟⲛⲏⲣⲟⲛ	ⲡⲟⲛⲏⲣⲟⲛ	1
ⲛⲟⲩ ϩⲓⲥⲉ	ϩⲓⲥⲉ	1
ⲙⲁ ⲛⲓⲙ ⲉⲧ ⲕ ⲛⲁ ⲃⲱⲕ ⲉⲣⲟ ⲟⲩ	ⲙⲁ	1
ⲧ ϩⲉⲛⲉⲉⲧⲉ ⲉⲧ ⲙⲙⲁⲁⲩ	ϩⲉⲛⲉⲉⲧⲉ	1
ⲟⲩⲁ ⲉ ϥ ⲛⲉϫ ⲇⲁⲓⲙⲱⲛⲓⲟⲛ ⲉⲃⲟⲗ ϩⲙ ⲡⲉⲕ ⲣⲁⲛ	ⲟⲩⲁ	1
ⲡ ⲟⲩⲁ ⲉⲧ ⲛ ⲛⲁ ⲧⲟϭ ⲕ ⲉⲣⲟ ϥ	ⲟⲩⲁ	1
ⲟⲩ ϩⲟⲟⲩ ⲛ ⲣⲱⲙⲉ	ϩⲟⲟⲩ	1
ⲛ ⲁⲣⲉⲧⲏ · ⲙ ⲡ ⲛⲟⲩⲧⲉ	ⲁⲣⲉⲧⲏ	1
ⲥⲉ ⲛ ⲧⲃⲁ ⲙ ⲙⲁⲧⲟⲓ	ⲙⲁⲧⲟⲓ	1
ϯ ⲉⲡⲓⲥⲧⲟⲗⲏ	ⲉⲡⲓⲥⲧⲟⲗⲏ	1
ⲡⲟⲩ ⲛⲁ ⲛ ϩⲁⲉ ⲉϩⲟⲩⲉ ⲡ ϣⲟⲣⲡ	ⲛⲁ	1
ⲛⲟⲩ ϯⲧⲱⲛ	ϯⲧⲱⲛ	1
ⲛ ⲉⲧ ⲉⲓⲣⲉ ⲙⲙⲟ ⲟⲩ	ⲛ	1
ⲛ ⲣⲉϥϫⲓⲛϭⲟⲛⲥ	ⲣⲉϥϫⲓⲛϭⲟⲛⲥ	1
ⲗⲁⲁⲩ ⲁⲛ ⲙ ⲡ ⲉⲧ ⲛⲁⲛⲟⲩ ϥ ⲛⲁ ⲩ	ⲗⲁⲁⲩ	1
ⲡ ⲉⲛⲧ ⲁ ϥ ϣⲱⲡⲉ	ⲡ	1
ⲡ ϣⲏⲣⲉ ⲙ ⲡ ⲛⲟⲩⲧⲉ	ϣⲏⲣⲉ	1
ⲥⲟⲫⲓⲁ ⲉⲃⲟⲗ ϩⲓⲧⲙ ⲡ ⲛⲟⲩⲧⲉ	ⲥⲟⲫⲓⲁ	1
ⲡ ⲁⲣⲭⲏⲉⲡⲓⲥⲕⲟⲡⲟⲥ ⲛ ⲣⲁⲕⲟⲧⲉ	ⲁⲣⲭⲏⲉⲡⲓⲥⲕⲟⲡⲟⲥ	1
ⲡⲁ ⲙⲁ ⲛ ϣⲱⲱⲡⲉ	ⲙⲁ	1
ⲡ ϫⲟϥϫϥ ⲙ ⲡⲉ ⲑⲃⲃⲓⲟ	ϫⲟϥϫϥ	1
ⲧ ⲁⲣⲭⲏ ⲙ ⲡ ⲱϩⲥ ⲛ ⲉⲓⲱⲧ	ⲁⲣⲭⲏ	1
ⲡⲉ ⲕⲗⲟⲙ ⲡⲁⲓ ⲉⲧ ϩⲙ ⲡⲉⲕ ϣⲱⲛⲧ ⲡⲱⲕ	ⲕⲗⲟⲙ	1
ⲑⲗⲓⲯⲓⲥ ⲛⲓⲙ	ⲑⲗⲓⲯⲓⲥ	1
ⲛⲕⲁ ⲛⲓⲙ ⲉ ϥ ⲙ ⲡ ⲃⲟⲗ ⲙ ⲡ ⲣⲱⲙⲉ ⲉ ϥ ⲛⲁ ⲃⲱⲕ ⲉϩⲟⲩⲛ ⲉⲣⲟ ϥ	ⲛⲕⲁ	1
ⲛⲟⲩ ϩⲃⲏⲩⲉ	ϩⲃⲏⲩⲉ	1
ⲡⲁ ⲧⲁϣⲉⲟⲉⲓϣ	ⲧⲁϣⲉⲟⲉⲓϣ	1
ⲡ ⲉⲧ ⲱⲃϣ ⲙⲙⲟ ϥ ⲉ ⲧⲙ ϯ ϯⲧⲉⲟⲩⲱ ⲙ ⲡ ϩⲏⲕⲉ ⲛ ⲛⲁⲏⲧ	ⲡ	1
ⲟⲩ ⲙⲟⲛⲁⲭⲟⲥ ⲉⲃⲟⲗ ϩⲛ ⲛ ϩⲗⲗⲟ	ⲙⲟⲛⲁⲭⲟⲥ	1
ⲟⲩ ⲥⲟⲫⲓⲁ ⲛⲧⲉ ⲡ ⲛⲟⲩⲧⲉ	ⲥⲟⲫⲓⲁ	1
ⲧ ϩⲉ ⲛⲧ ⲁ ϥ ⲟⲩⲁϣ ⲥ	ϩⲉ	1
ⲛ ⲥⲟϭ ⲛⲧⲉ ⲡ ⲕⲟⲥⲙⲟⲥ	ⲥⲟϭ	1
ⲡ ϩⲁⲣⲉϩ ⲉ ⲛⲉⲧⲛ ϩⲓⲥⲉ ⲛⲏ ⲧⲛ	ϩⲁⲣⲉϩ	1
ⲛⲉ ϭⲣⲱϭ ⲧⲏⲣ ⲟⲩ ⲉⲧ ϩⲓϫⲙ ⲡ ⲕⲁϩ	ϭⲣⲱϭ	1
ⲗⲓⲃⲁⲛⲟⲥ	ⲗⲓⲃⲁⲛⲟⲥ	1
ⲡ ⲉⲧⲉ ⲙⲛ ⲗⲁⲁⲩ ⲙ ⲙⲛⲧϫⲁⲥⲓϩⲏⲧ ϩⲏⲡ ⲛϩⲏⲧ ϥ	ⲡ	1
ⲡ ϣⲏⲣⲉ ⲙ ⲡ ⲛⲟⲩⲧⲉ · ⲡ ⲥⲱⲧⲏⲣ · ⲡ ϫⲟⲉⲓⲥ · ⲧ ⲧⲁⲝⲓⲥ ⲛ ⲛ ⲉⲧ ϩⲙ ⲡ ⲁⲏⲣ	ϣⲏⲣⲉ	1
ⲡ ⲉⲧ ϫⲟⲟⲣ ⲉⲣⲟ ⲓ	ⲡ	1
ⲙⲛⲧⲁⲕⲁⲑⲁⲣⲧⲟⲥ ⲛⲓⲙ	ⲙⲛⲧⲁⲕⲁⲑⲁⲣⲧⲟⲥ	1
ⲓⲏⲥⲟⲩ ⲡ ϣⲏⲣⲉ ⲛ ⲛⲁⲩⲏ	ⲓⲏⲥⲟⲩ	1
ⲛⲉⲩ ⲧⲟϣ	ⲧⲟϣ	1
ⲡⲉϥ ⲣⲁⲥⲧⲉ	ⲣⲁⲥⲧⲉ	1
ⲡ ⲉⲃⲟⲧ ⲫⲁⲣⲙⲟⲩⲧⲉ	ⲫⲁⲣⲙⲟⲩⲧⲉ	1
ⲥⲩⲛⲁⲅⲱⲅⲏ ⲛⲓⲙ ⲉⲧ ϣⲟⲟⲡ ⲕⲁⲧⲁ ⲡⲉⲛ ⲃⲓⲟⲥ	ⲥⲩⲛⲁⲅⲱⲅⲏ	1
ⲛ ⲉⲧ ϫⲓ ⲛ ϭⲟⲛⲥ	ⲛ	1
ⲡ ϩⲏⲧ ⲛ ⲧⲉⲕ ϩⲙϩⲁⲗ	ϩⲏⲧ	1
ⲩ ϩⲉⲗⲗⲏⲛ ⲧⲉ ⲛ ⲣⲙ ⲧⲉ ⲫⲟⲓⲛⲓⲕⲏ ⲛ ⲧ ⲥⲩⲣⲓⲁ	ϩⲉⲗⲗⲏⲛ	1
ⲟⲩ ⲧⲟⲟⲩ ⲉ ϥ ϫⲟⲥⲉ	ⲧⲟⲟⲩ	1
ⲡⲁ ⲙⲉⲣⲓⲧ ⲛ ⲥⲟⲛ ⲁⲡⲁ ϩⲓⲉⲣⲁⲝ	ϩⲓⲉⲣⲁⲝ	1
ⲡ ⲣⲟ ⲛ ⲛ ⲉⲧ ⲉⲓⲛⲉ ⲙⲙⲟ ⲕ	ⲣⲟ	1
ⲛⲉ ⲡⲣⲟⲥⲟⲩⲟⲉⲓϣ	ⲡⲣⲟⲥⲟⲩⲟⲉⲓϣ	1
ⲛ ϣⲏⲣⲉ ⲙ ⲡ ⲙⲁ ⲛ ϣⲉⲗⲉⲉⲧ	ϣⲏⲣⲉ	1
ⲙ ⲙⲓⲗⲓⲟⲛ	ⲙⲓⲗⲓⲟⲛ	1
ⲧ ⲡⲁⲛϩⲟⲡⲗⲓⲁ ⲙ ⲡ ⲛⲟⲩⲧⲉ	ⲡⲁⲛϩⲟⲡⲗⲓⲁ	1
ⲧⲉⲧⲛ ⲑⲗⲓⲯⲓⲥ	ⲑⲗⲓⲯⲓⲥ	1
ⲧ ⲕⲉ ⲙⲛⲧⲣⲉϥϣⲡϩⲓⲥⲉ ⲙ ⲡ ⲥⲱⲙⲁ	ⲙⲛⲧⲣⲉϥϣⲡϩⲓⲥⲉ	1
ⲡⲉ ϩⲙⲟⲩ ⲙ ⲡⲉ ⲭⲣⲓⲥⲧⲟⲥ	ϩⲙⲟⲩ	1
ⲣⲉϥϣⲙϣⲉⲉⲓⲇⲱⲗⲟⲛ	ⲣⲉϥϣⲙϣⲉⲉⲓⲇⲱⲗⲟⲛ	1
ⲛ ⲥⲱϣⲉ ⲉⲧ ϩⲙ ⲡⲉⲩ ⲕⲱⲧⲉ	ⲥⲱϣⲉ	1
ⲣⲱⲙⲉ ⲛⲓⲙ ⲛ ⲗⲟⲅⲓⲕⲟⲛ	ⲣⲱⲙⲉ	1
ⲙ ⲙⲁⲧⲟⲓ ⲙ ⲡⲉ ⲭⲣⲓⲥⲧⲟⲥ	ⲙⲁⲧⲟⲓ	1
ⲡ ⲕⲉⲗⲱⲗ	ⲕⲉⲗⲱⲗ	1
ⲡ ϩⲁⲡ ⲙ ⲙⲉ	ϩⲁⲡ	1
ⲛⲟⲩ ϫⲓⲟⲩⲉ	ϫⲓⲟⲩⲉ	1
ⲛ ⲟⲩⲁ ⲛ ⲛⲉ ⲡⲣⲟⲫⲏⲧⲏⲥ	ⲟⲩⲁ	1
ⲛ ⲉⲓⲇⲱⲗⲟⲛ ⲉⲧ ϩⲙ ⲡⲉⲕ ⲏⲓ	ⲉⲓⲇⲱⲗⲟⲛ	1
ⲡ ⲟⲩϫⲁⲓ	ⲟⲩϫⲁⲓ	1
ⲡ ⲕⲁϩ ⲧⲏⲣ ϥ	ⲕⲁϩ	1
ⲛⲁ ⲡⲉ ⲭⲣⲓⲥⲧⲟⲥ ⲛⲉ ⲛⲧ ⲁ ϥ ⲧⲁⲁ ⲩ ⲛⲁ ⲩ ⲉ ⲩ ⲁⲡⲟⲗⲁⲩⲥⲓⲥ . ⲁⲩⲱ ⲣⲣⲙⲙⲁⲟ ϩⲛ ϩⲉⲛ ϩⲃⲏⲩⲉ ⲉ ⲛⲁⲛⲟⲩ ⲟⲩ	ⲛⲁ	1
ⲛⲉ ⲩϣⲟⲟⲩⲉ	ⲩϣⲟⲟⲩⲉ	1
ⲟⲩ ϣⲏⲛ ⲛ ⲱⲛϩ ⲉ ϥ ⲡⲏⲧ ⲉ ⲡ ϫⲓⲥⲉ	ϣⲏⲛ	1
ⲡ ⲉⲛⲧ ⲁ ⲕ ϫⲟⲟ ⲥ ⲛϩⲏⲧ ⲟⲩ ϫⲉ ⲥⲣϥⲉ ⲛ ⲧⲉⲧⲛ ⲉⲓⲙⲉ ϫⲉ ⲁⲛⲟⲕ ⲡⲉ ⲡ ⲛⲟⲩⲧⲉ	ⲡ	1
ⲡ ⲉⲛⲧ ⲁ ϥ ⲟⲩⲱⲛϩ ⲉⲃⲟⲗ ⲛ ⲛⲉ ⲡⲣⲟⲫⲏⲧⲏⲥ · ⲙⲛ ⲛⲉϥ ⲁⲡⲟⲥⲧⲟⲗⲟⲥ	ⲡ	1
ⲡ ϫⲡⲉϩⲟⲟⲩ	ϫⲡⲉϩⲟⲟⲩ	1
ⲡ ⲏⲓ ⲙ ⲡ ϫⲟⲉⲓⲥ	ⲏⲓ	1
ⲡⲁ ϣⲏⲣⲉ ⲡⲁ ⲙⲉⲣⲓⲧ	ϣⲏⲣⲉ	1
ⲡⲉⲛ ⲟⲩⲣⲟⲧ	ⲟⲩⲣⲟⲧ	1
ϩⲉⲛ ⲧⲱⲱⲧⲉ	ⲧⲱⲱⲧⲉ	1
ⲁϥⲣⲁϩⲁⲙ ⲡⲉϥ ⲙⲁⲑⲏⲧⲏⲥ	ⲁϥⲣⲁϩⲁⲙ	1
ⲛ ⲉⲧⲉ ⲙⲛⲧⲁ ⲩ	ⲛ	1
ⲧⲉⲥ ⲙⲛⲧϩⲗⲗⲱ	ⲙⲛⲧϩⲗⲗⲱ	1
ⲡ ⲧϭⲁⲉⲓⲟ	ⲧϭⲁⲉⲓⲟ	1
ⲛ ⲉⲛⲧ ⲁ ⲩ ⲛⲁⲩ ⲉⲣⲟ ⲟⲩ	ⲛ	1
ⲧ ⲁⲫⲟⲣⲙⲏ ⲛ ϫⲱⲕⲙ ϩⲛ ϩⲉⲛ ⲥⲓⲟⲟⲩⲛⲉ	ⲁⲫⲟⲣⲙⲏ	1
ⲫⲓⲗⲓⲡⲡⲟⲥ ⲡⲉϥ ⲥⲟⲛ	ⲫⲓⲗⲓⲡⲡⲟⲥ	1
ⲡⲉⲥ ⲙⲡϣⲁ	ⲙⲡϣⲁ	1
ⲛⲉϥ ⲥⲩⲅⲅⲉⲛⲏⲥ	ⲥⲩⲅⲅⲉⲛⲏⲥ	1
ⲟⲩ ⲇⲱⲣⲟⲛ	ⲇⲱⲣⲟⲛ	1
ⲧ ⲙⲛⲧϩⲙϩⲁⲗ ⲛ ⲛⲉ ϩⲃⲏⲩⲉ ⲉⲧ ⲟϣ	ⲙⲛⲧϩⲙϩⲁⲗ	1
ⲧ ⲙⲛⲧⲛⲟⲩⲧⲉ	ⲙⲛⲧⲛⲟⲩⲧⲉ	1
ⲡ ⲏⲓ ⲙ ⲡ ϫⲱⲱⲣⲉ	ⲏⲓ	1
ⲟⲩ ⲃⲁⲗⲗⲁⲧⲓⲟⲛ ⲉ ⲩⲛ ⲙⲏⲧ ⲛ ϣⲉ ⲛ ϩⲟⲗⲟⲕⲟⲧⲧⲓⲛⲟⲥ ϩⲓⲱⲱ ⲥ	ⲃⲁⲗⲗⲁⲧⲓⲟⲛ	1
ⲡⲉϥ ⲥⲟⲟⲩⲛ	ⲥⲟⲟⲩⲛ	1
ⲛ ⲟⲩⲉϭⲣⲟ ⲙ ⲡⲉⲕ ⲏⲓ	ⲟⲩⲉϭⲣⲟ	1
ⲛⲉϥ ϣⲁϫⲉ ⲧⲏⲣ ⲟⲩ ⲉⲧⲉ ⲙⲛ ϩⲩⲡⲟⲕⲣⲓⲥⲓⲥ ⲛϩⲏⲧ ⲟⲩ	ϣⲁϫⲉ	1
ⲡⲉⲛ ⲡⲁⲥⲭⲁ	ⲡⲁⲥⲭⲁ	1
ⲉⲡⲓⲥⲕⲟⲡⲟⲥ	ⲉⲡⲓⲥⲕⲟⲡⲟⲥ	1
ⲛ ⲕⲉ ⲇⲁⲓⲙⲱⲛⲓⲟⲛ	ⲇⲁⲓⲙⲱⲛⲓⲟⲛ	1
ⲡ ⲉⲧⲉⲣ ⲁ ⲁⲓⲧⲉⲓ ⲙⲙⲟ ⲓ ⲙⲙⲟ ϥ	ⲡ	1
ⲡⲉⲥ ⲥⲛⲟϥ	ⲥⲛⲟϥ	1
ⲡⲉⲥ ⲥⲱⲙⲁ	ⲥⲱⲙⲁ	1
ⲡⲉϥ ⲥⲱⲃⲁϩ	ⲥⲱⲃⲁϩ	1
ⲡ ϩⲏⲕⲉ ⲛ ⲛⲁⲏⲧ	ϩⲏⲕⲉ	1
ⲙⲛⲧⲥⲛⲟⲟⲩⲥ ⲛ ⲗⲟⲟⲩ ⲛ ⲃⲛⲛⲉ	ⲗⲟⲟⲩ	1
ⲡ ϩⲟ ⲛ ⲗⲁⲁⲩ ⲛ ⲣⲱⲙⲉ	ϩⲟ	1
ⲧ ⲅⲉⲛⲉⲁ ⲛ ⲁⲧⲛⲁϩⲧⲉ	ⲅⲉⲛⲉⲁ	1
ⲡ ⲣⲁⲛ ⲇⲉ ⲛ ⲧ ϩⲉⲛⲉⲉⲧⲉ ⲉⲧ ⲙⲙⲁⲁⲩ	ⲣⲁⲛ	1
ϣⲁ ⲉⲛⲉϩ	ⲉⲛⲉϩ	1
ⲛ ⲁⲧⲛⲟⲩⲧⲉ	ⲁⲧⲛⲟⲩⲧⲉ	1
ⲛ ⲉⲧ ⲛϩⲏⲧ ⲟⲩ ⲧⲏⲣ ⲟⲩ	ⲛ	1
ⲧ ⲧⲟⲉⲓⲥ ⲛ ϣⲁⲓ	ⲧⲟⲉⲓⲥ	1
ⲟⲩ ⲉⲛⲧⲏϭ	ⲉⲛⲧⲏϭ	1
ⲓⲏⲥⲟⲩⲥ ⲡⲉ ⲭⲣⲓⲥⲧⲟⲥ	ⲓⲏⲥⲟⲩⲥ	1
ⲛ ⲉⲧ ϣⲟⲟⲡ ⲛⲁ ϥ	ⲛ	1
ⲧⲉ ⲑⲩⲥⲓⲁ ⲛ ⲛ ⲁⲥⲉⲃⲏⲥ	ⲑⲩⲥⲓⲁ	1
ⲡⲁ ⲣⲟⲟⲩϣ ⲧⲏⲣ ϥ	ⲣⲟⲟⲩϣ	1
ⲡ ⲗⲟⲅⲟⲥ	ⲗⲟⲅⲟⲥ	1
ⲛⲓ ϣⲏⲣⲉ ϣⲏⲙ	ϣⲏⲣⲉ	1
ⲡ ϣⲏⲣⲉ ϩⲱⲱ ϥ ⲙ ⲡ ⲣⲱⲙⲉ	ϣⲏⲣⲉ	1
ⲟⲩ ⲙⲛⲧⲣⲉϥϫⲓⲟⲩⲁ	ⲙⲛⲧⲣⲉϥϫⲓⲟⲩⲁ	1
ⲡⲉ ϯ ⲛⲁ ⲁⲁ ϥ	ⲡⲉ	1
ⲛⲁⲓ ⲉⲧⲉ ⲟⲩⲛⲧⲁ ⲩ ⲙⲙⲁⲩ ⲛ ⲧⲉⲩ ⲡⲓⲥⲧⲓⲥ ⲉ ⲥ ϫⲏⲕ ⲉⲃⲟⲗ ⲉϩⲟⲩⲛ ⲉ ⲡⲉ ⲭⲣⲓⲥⲧⲟⲥ . ⲁⲩⲱ ⲉⲧ ⲁϩⲉ ⲉ ⲡⲉ ⲡⲛⲉⲩⲙⲁ ⲙ ⲡ ⲛⲟⲩⲧⲉ	ⲛⲁⲓ	1
ⲛⲉ ⲡⲣⲉⲥⲃⲩⲧⲉⲣⲟⲥ ⲛ ⲧ ⲉⲕⲕⲗⲏⲥⲓⲁ	ⲡⲣⲉⲥⲃⲩⲧⲉⲣⲟⲥ	1
ⲧⲉⲓ ⲡⲓⲥⲧⲓⲥ	ⲡⲓⲥⲧⲓⲥ	1
ⲡ ⲇⲓⲕⲁⲓⲱⲙⲁ ϫⲓⲛ ⲛ ϣⲟⲣⲡ ϩⲙ ⲡ ⲓⲥⲣⲁⲏⲗ ⲉⲧⲃⲉ ⲡ ⲉⲧ ϫⲓ ⲉϩⲟⲩⲛ ⲉ ⲡ ⲅⲉⲛⲟⲥ ⲁⲩⲱ ⲉⲧⲃⲉ ⲧ ϣⲃⲓⲱ	ⲇⲓⲕⲁⲓⲱⲙⲁ	1
ⲡⲓ ⲗⲁⲟⲥ	ⲗⲁⲟⲥ	1
ⲧⲟⲩ ϣⲉⲗⲉⲉⲧ ⲉⲛⲧ ⲁ ⲥ ⲙⲉⲣⲓⲧ ⲉ	ϣⲉⲗⲉⲉⲧ	1
ⲡⲉ ⲡⲛⲉⲩⲙⲁ ⲙ ⲡⲉⲓ ⲕⲟⲥⲙⲟⲥ	ⲡⲛⲉⲩⲙⲁ	1
ⲛⲉⲛ ⲙⲛⲧⲥⲟϭ	ⲙⲛⲧⲥⲟϭ	1
ⲡⲉϥ ⲧⲟⲟⲩⲉ	ⲧⲟⲟⲩⲉ	1
ⲡ ⲉⲧⲉ ⲙⲡⲉ ϥ ϭⲱ ⲉⲛⲉϩ	ⲡ	1
ⲛⲉⲧⲛ ⲡⲓⲥⲧⲓⲥ	ⲡⲓⲥⲧⲓⲥ	1
ϩⲉⲛ ⲁⲧⲑⲁⲃ ⲛ ⲧⲃⲃⲟ ϩⲓ ⲙⲉ	ⲁⲧⲑⲁⲃ	1
ⲡ ⲉⲟⲟⲩ ⲙ ⲡⲉϥ ⲉⲓⲱⲧ ⲙⲛ ⲛ ⲁⲅⲅⲉⲗⲟⲥ ⲉⲧ ⲟⲩⲁⲁⲃ	ⲉⲟⲟⲩ	1
ⲡ ⲉⲩⲁⲅⲅⲉⲗⲓⲟⲛ ⲙ ⲡ ⲛⲟⲩⲧⲉ	ⲉⲩⲁⲅⲅⲉⲗⲓⲟⲛ	1
ⲙⲛⲧⲣⲙϩⲉ ⲙ ⲙⲉ	ⲙⲛⲧⲣⲙϩⲉ	1
ⲡⲓ ⲑⲁⲃ ⲛ ⲁⲥ	ⲑⲁⲃ	1
ⲛⲉϥ ⲭⲣⲏⲙⲁ ⲧⲏⲣ ⲟⲩ	ⲭⲣⲏⲙⲁ	1
ⲟⲩ ⲛⲟϭ ⲛ ϩⲱⲃ	ϩⲱⲃ	1
ⲧ ⲡⲁⲣⲑⲉⲛⲟⲥ ⲙ ⲡ ⲓⲥⲣⲁⲏⲗ	ⲡⲁⲣⲑⲉⲛⲟⲥ	1
ⲧⲉⲕ ⲙⲛⲧⲛⲟϭ ⲛ ⲁⲧⲛⲁⲩ ⲉⲣⲟ ⲥ · ⲧⲁⲓ ⲉⲧⲉ ⲛ ⲥ ⲟⲩⲟⲛϩ ⲉⲣⲟ ⲛ ⲁⲛ ⲧⲉⲛⲟⲩ	ⲙⲛⲧⲛⲟϭ	1
ⲡ ⲙⲉⲉⲩⲉ	ⲙⲉⲉⲩⲉ	1
ⲙ ⲙⲁⲁϫⲉ ⲙ ⲡ ⲥⲱⲙⲁ	ⲙⲁⲁϫⲉ	1
ⲡ ⲙⲁⲕⲁⲣⲓⲟⲥ ⲁⲛⲧⲱⲛⲓⲟⲥ	ⲁⲛⲧⲱⲛⲓⲟⲥ	1
ⲧ ⲅⲉϩⲉⲛⲛⲁ ⲛ ⲥⲁⲧⲉ	ⲅⲉϩⲉⲛⲛⲁ	1
ⲟⲩ ⲣⲱⲙⲉ ⲉ ϥ ⲟ ⲛ ⲇⲁⲓⲙⲱⲛⲓⲟⲛ · ⲁⲩⲱ ⲉ ϥ ⲙⲟⲕϩ ⲙⲙⲁⲧⲉ · ⲉ ϥ ⲧⲁⲩⲉ ⲥϩⲃⲏⲏⲧⲉ ⲉⲃⲟⲗ	ⲣⲱⲙⲉ	1
ϩⲉⲛ ⲕⲉ ϩⲃⲏⲩⲉ ⲧⲏⲣ ⲟⲩ ⲉ ⲩ ⲧⲛⲧⲱⲛ ⲉ ⲛⲁⲓ	ϩⲃⲏⲩⲉ	1
ⲁⲛⲇⲣⲉⲁⲥ ⲡ ⲥⲟⲛ ⲛ ⲥⲓⲙⲱⲛ	ⲁⲛⲇⲣⲉⲁⲥ	1
ⲛ ⲁⲡⲟⲥⲧⲟⲗⲟⲥ ⲧⲏⲣ ⲟⲩ	ⲁⲡⲟⲥⲧⲟⲗⲟⲥ	1
ⲧⲉⲥ ϣⲉⲉⲣⲉ	ϣⲉⲉⲣⲉ	1
ⲡ ⲥⲁⲉⲓⲛ ⲛ ⲡⲉⲛ ⲥⲱⲙⲁ	ⲥⲁⲉⲓⲛ	1
ⲛ ⲉⲧ ⲙⲟⲟϣⲉ	ⲛ	1
ⲛ ϭⲁⲃϩⲏⲧ	ϭⲁⲃϩⲏⲧ	1
ⲡ ⲁⲅⲱⲛ ⲉⲧ ⲛⲁⲛⲟⲩ ϥ ⲛⲧ ⲁ ϥ ⲧⲁϩⲙⲉ ⲧ ⲉⲣⲟ ϥ	ⲁⲅⲱⲛ	1
ⲡ ⲃⲟⲗ ⲛ ⲧⲉϥ ⲣⲓ	ⲃⲟⲗ	1
ⲡⲉⲛ ⲣⲟⲟⲩϣ	ⲣⲟⲟⲩϣ	1
ⲛ ⲉⲛⲧ ⲁ ⲩ ⲥⲉⲉⲡⲉ ⲉⲣⲟ ⲥ ϩⲛ ⲛ ⲉⲛⲧ ⲁ ⲥ ⲥⲉⲓ ⲛϩⲏⲧ ⲟⲩ	ⲛ	1
ⲡⲁϩⲟⲩ ⲙⲙⲟ ϥ	ⲡⲁϩⲟⲩ	1
ⲡⲁϩⲟⲩ ⲙⲙⲟ ⲓ	ⲡⲁϩⲟⲩ	1
ⲛ ⲉⲛⲧ ⲁ ⲧⲉⲧⲛ ⲁⲁ ⲩ ϩⲛ ⲟⲩ ⲙⲛⲧⲁⲧⲥⲟⲟⲩⲛ	ⲛ	1
ⲟⲩⲟⲛ ⲛⲓⲙ ⲉⲧ ⲉⲡⲓⲕⲁⲗⲉⲓ ⲙ ⲡ ⲣⲁⲛ ⲙ ⲡⲉⲛ ϫⲟⲉⲓⲥ ⲓⲏⲥⲟⲩⲥ ⲡⲉ ⲭⲣⲓⲥⲧⲟⲥ ϩⲙ ⲙⲁ ⲛⲓⲙ ⲛⲧⲁ ⲩ ⲛⲙⲙⲁ ⲛ	ⲟⲩⲟⲛ	1
ⲡ ⲙⲟⲥⲧⲉ	ⲙⲟⲥⲧⲉ	1
ⲛ ⲧⲟϣ ⲛ ⲧ ⲇⲉⲕⲁⲡⲟⲗⲓⲥ	ⲧⲟϣ	1
ⲡ ⲕⲉ ⲏⲓ ⲛ ⲥⲧⲉⲫⲁⲛⲁ	ⲏⲓ	1
ⲟⲩ ⲥⲱⲙⲁ ⲛ ⲟⲩⲱⲧ	ⲥⲱⲙⲁ	1
ⲟⲩⲟⲛ ⲛⲓⲙ ⲉⲧ ⲛⲁ ϫⲁϩⲙ ⲟⲩ ⲕⲁⲧⲁ ⲗⲁⲁⲩ ⲛ ⲥⲙⲟⲧ · ⲉⲓⲧⲉ ϩⲟⲟⲩⲧ · ⲉⲓⲧⲉ ⲥϩⲓⲙⲉ ϩⲣⲁⲓ ϩⲛ ⲉ ⲩ ⲥⲩⲛⲁⲅⲱⲅⲏ ⲛⲓⲙ ⲉⲧ ϣⲟⲟⲡ ⲕⲁⲧⲁ ⲡⲉⲛ ⲃⲓⲟⲥ	ⲟⲩⲟⲛ	1
ϩⲉⲛ ⲡⲟⲣⲛⲉⲓⲁ	ⲡⲟⲣⲛⲉⲓⲁ	1
ⲡ ⲃⲉⲉⲕⲉ ϯ ϫⲡⲟ ⲙⲙⲟ ϥ	ⲃⲉⲉⲕⲉ	1
ⲡⲉ ⲕⲗⲟⲙ ⲛ ⲛ ⲉⲧ ⲟⲩⲁⲁⲃ ⲧⲏⲣ ⲟⲩ	ⲕⲗⲟⲙ	1
ⲥⲁⲣⲕⲓⲕⲟⲥ	ⲥⲁⲣⲕⲓⲕⲟⲥ	1
ⲁⲑⲁⲛⲁⲥⲓⲟⲥ ⲡ ⲁⲣⲭⲏⲉⲡⲓⲥⲕⲟⲡⲟⲥ ⲛ ⲣⲁⲕⲟⲧⲉ	ⲁⲑⲁⲛⲁⲥⲓⲟⲥ	1
ⲡ ⲉⲧ ⲉⲓⲣⲉ ⲙⲙⲟ ϥ	ⲡ	1
ⲡ ⲕⲱⲧⲉ ⲛ ⲧⲩⲣⲟⲥ ⲙⲛ ⲥⲓⲇⲱⲛ	ⲕⲱⲧⲉ	1
ⲡⲉ ϣⲃⲣⲣϩⲱⲃ ⲛ ⲛ ⲉⲛⲧ ⲁ ⲩ ϣⲱⲱⲧ ϩⲙ ⲡ ⲧⲟⲕ ⲙ ⲡⲉ ⲅⲣⲁⲙⲙⲁⲧⲉⲩⲥ ⲛ ⲛ ⲥⲉⲗⲓⲥ ⲙ ⲡ ϫⲱⲱⲙⲉ ⲛ ⲛ ϣⲁϫⲉ ⲛⲧ ⲁ ⲛⲉ ⲡⲣⲟⲫⲏⲧⲏⲥ ϫⲟⲟⲩ ⲥⲉ ⲛⲁ ⲩ ϩⲙ ⲡ ⲣⲁⲛ ⲙ ⲡ ⲛⲟⲩⲧⲉ	ϣⲃⲣⲣϩⲱⲃ	1
ⲧ ϩⲏ ⲙ ⲡⲉ ⲩⲟⲉⲓϣ	ϩⲏ	1
ⲛ ⲉⲧⲉ ⲛ ⲥⲉ ϣⲟⲟⲡ ⲁⲛ	ⲛ	1
ⲩ ⲙⲛⲧⲣⲉϥϣⲙϣⲉⲛⲟⲩⲧⲉ	ⲙⲛⲧⲣⲉϥϣⲙϣⲉⲛⲟⲩⲧⲉ	1
ⲡ ⲕⲱϩⲧ ⲡ ⲉⲧ ⲛⲁ ⲇⲟⲕⲓⲙⲁⲍⲉ ⲙⲙⲟ ϥ	ⲕⲱϩⲧ	1
ϩⲟⲙⲛⲧ ⲉ ⲛⲉⲩ ⲙⲟϫϩ	ϩⲟⲙⲛⲧ	1
ⲁⲟⲩⲏⲣ ⲛ ⲣⲟⲙⲡⲉ	ⲁⲟⲩⲏⲣ	1
ⲡ ϥⲁⲓⲣⲟⲟⲩϣ ⲙⲁⲩⲁⲁ ϥ ϩⲁ ⲛⲉϥ ϩⲙϩⲁⲗ	ϥⲁⲓⲣⲟⲟⲩϣ	1
ⲛⲉϥ ϩⲃⲏⲩⲉ ⲙ ⲡⲟⲛⲏⲣⲟⲛ	ϩⲃⲏⲩⲉ	1
ⲡ ϣⲓⲕ ⲛ ⲧ ⲁⲛⲟⲙⲓⲁ	ϣⲓⲕ	1
ⲡⲁ ϣⲏⲣⲉ ⲓⲥⲁⲁⲕ	ⲓⲥⲁⲁⲕ	1
ⲧ ϭⲓϫ ⲛ ⲧ ϣⲉⲉⲣⲉ ϣⲏⲙ	ϭⲓϫ	1
ⲡ ϫⲟⲉⲓⲥ ⲙ ⲡ ⲉⲟⲟⲩ ⲓⲏⲥⲟⲩⲥ	ⲓⲏⲥⲟⲩⲥ	1
ⲡ ⲉⲧ ⲉϣϣⲉ	ⲡ	1
ⲛ ⲉⲧ ⲣϫⲓⲛϭⲟⲛⲥ	ⲛ	1
ⲡ ⲧⲟⲕ ⲙ ⲡⲉ ⲅⲣⲁⲙⲙⲁⲧⲉⲩⲥ	ⲧⲟⲕ	1
ⲛ ⲉⲧ ⲫⲑⲟⲛⲉⲓ ⲅⲁⲣ ⲉⲣⲟ ⲛ	ⲛ	1
ⲟⲩ ⲛⲟϭ ⲛ ϩⲉⲑⲛⲟⲥ	ϩⲉⲑⲛⲟⲥ	1
ⲥⲁϣϥ ⲛ ϣⲏⲣⲉ	ϣⲏⲣⲉ	1
ⲟⲩ ⲡⲟⲛⲏⲣⲓⲁ	ⲡⲟⲛⲏⲣⲓⲁ	1
ⲧ ϣⲱⲙⲉ ⲇⲉ ⲛ ⲥⲓⲙⲱⲛ	ϣⲱⲙⲉ	1
ⲡ ⲣⲟ ⲙ ⲡ ⲁⲡⲟⲗⲗⲱⲛ ⲙⲛ ⲧ ⲁⲣⲧⲉⲙⲓⲥ	ⲣⲟ	1
ⲡⲉ ϫⲛⲟⲟⲩ ⲛ ⲛⲉϥ ⲉⲓⲱⲧ	ϫⲛⲟⲟⲩ	1
ⲛⲉⲩ ϣⲏⲣⲉ	ϣⲏⲣⲉ	1
ⲡ ⲙⲁ ⲉⲧ ⲟⲩ ⲥⲟⲟⲩⲛ ϫⲉ ⲛ ⲥⲉ ⲣⲟⲉⲓⲥ ⲁⲛ ⲛϩⲏⲧ ϥ ⲁⲩⲱ ⲥⲉ ⲟⲃϣ	ⲙⲁ	1
ⲙ ⲙⲁ ⲛ ϣⲁ	ⲙⲁ	1
ⲛⲉⲩ ϣⲱⲛⲉ	ϣⲱⲛⲉ	1
ⲛⲉⲩ ⲥⲁⲛⲇⲁⲗⲓⲟⲛ	ⲥⲁⲛⲇⲁⲗⲓⲟⲛ	1
ⲛⲉⲓ ⲉⲡⲓⲑⲁⲛⲁⲧⲏⲥ	ⲉⲡⲓⲑⲁⲛⲁⲧⲏⲥ	1
ⲩ ⲛⲟⲩⲧⲉ ⲛ ⲟⲩⲱⲧ ⲡ ⲉⲓⲱⲧ ⲡ ⲡⲁⲛⲧⲟⲕⲣⲁⲧⲱⲣ	ⲛⲟⲩⲧⲉ	1
ⲕⲉ ⲙⲓⲛⲉ ⲛ ⲇⲓⲱⲅⲙⲟⲥ	ⲙⲓⲛⲉ	1
ⲧⲟⲟⲧ ⲕ	ⲧⲟⲟⲧ	1
ⲧⲉⲕ ⲙⲛⲧⲕⲟⲩⲓ	ⲙⲛⲧⲕⲟⲩⲓ	1
ⲛ ⲉⲧ ⲥⲟⲟⲩⲛ ⲇⲉ ⲙⲙⲟ ϥ	ⲛ	1
ⲡⲉϥ ϭⲗⲟϭ	ϭⲗⲟϭ	1
ⲡⲉϥ ϭⲣⲟϭ	ϭⲣⲟϭ	1
ⲡ ⲣⲟ ⲙ ⲡ ⲏⲓ	ⲣⲟ	1
ⲓⲱϩⲁⲛⲛⲏⲥ · ⲡ ⲉⲧⲉ ⲡⲱⲕ ⲡⲉ	ⲓⲱϩⲁⲛⲛⲏⲥ	1
ϩⲣⲱⲙⲁⲛⲟⲥ ⲇⲉ ⲡⲉ ⲥⲧⲣⲁⲧⲏⲗⲁⲧⲏⲥ	ϩⲣⲱⲙⲁⲛⲟⲥ	1
ⲡ ⲛⲟϭ ⲛ ⲛⲟⲩⲧⲉ ⲡ ⲁⲡⲟⲗⲗⲱⲛ	ⲁⲡⲟⲗⲗⲱⲛ	1
ⲧ ⲱⲇⲏ ⲙ ⲡ ⲏⲓ ⲙ ⲡ ϫⲟⲉⲓⲥ	ⲱⲇⲏ	1
ⲡ ⲉⲛⲧ ⲁ ϥ ⲁⲁ ⲧ ⲛ ϣⲙⲙⲟ ⲉ ⲧ ⲙⲁⲛⲓⲁ ⲉⲧ ϩⲟⲟⲩ · ⲧⲁⲓ ⲉⲧ ϣⲟⲟⲡ ϩⲛ ⲧ ⲥⲁⲣⲝ ⲉ ⲁ ϥ ⲧⲣ ⲁ ⲟⲩⲉ ⲉⲃⲟⲗ ⲙ ⲡ ⲙⲟⲩ ⲉⲧ ⲥⲁϣⲉ	ⲡ	1
ⲡ ⲕⲁϩ ⲙ ⲙⲱⲁⲃ	ⲕⲁϩ	1
ⲛ ⲙⲏⲏϣⲉ ⲛⲧ ⲁ ⲕ ϫⲟⲟ ⲥ	ⲙⲏⲏϣⲉ	1
ⲡ ⲉⲛⲧ ⲁ ϥ ⲉⲓ ⲉⲃⲟⲗ ϩⲛ ⲧⲟⲩ ⲧⲁⲡⲣⲟ	ⲡ	1
ⲛⲉⲕ ϩⲙϩⲁⲗ	ϩⲙϩⲁⲗ	1
ⲡ ⲟⲩⲟⲉⲓⲉ ⲉⲧ ⲏⲡ ⲉ ⲧⲡⲉ	ⲟⲩⲟⲉⲓⲉ	1
ⲧⲉⲓ ⲡⲁⲣⲁⲃⲟⲗⲏ	ⲡⲁⲣⲁⲃⲟⲗⲏ	1
ⲡⲉ ϩⲙⲟⲧ ⲛⲧⲉ ⲡ ⲛⲟⲩⲧⲉ ⲉⲛⲧ ⲁ ⲩ ⲧⲁⲁ ϥ ⲛⲁ ⲓ ϩⲱⲥ ⲥⲟⲫⲟⲥ ⲛ ⲁⲣⲭⲓⲧⲉⲕⲧⲱⲛ	ϩⲙⲟⲧ	1
ⲡ ⲱϩⲥ ⲧⲏⲣ ϥ ⲉⲧ ϣⲟⲟⲡ ⲛⲁ ⲓ	ⲱϩⲥ	1
ⲡ ⲉⲛⲧ ⲁ ϥ ⲧⲣⲉ ⲥ ϫⲣⲟ ⲉ ⲛⲉⲥ ϫⲁϫⲉ ϩⲙ ⲡ ⲧⲣⲉ ⲥ ⲡⲱⲧ ⲉⲣⲁⲧ ϥ	ⲡ	1
ⲡⲉⲓ ϫⲛⲟⲟⲩ	ϫⲛⲟⲟⲩ	1
ϣⲟⲙⲧ ⲙ ⲫⲟⲛⲟⲥ	ⲫⲟⲛⲟⲥ	1
ⲧⲉϥ ⲁⲥⲭⲏⲙⲟⲥⲩⲛⲏ	ⲁⲥⲭⲏⲙⲟⲥⲩⲛⲏ	1
ⲧ ϩⲓⲙⲉ ⲙ ⲡⲉϥ ⲉⲓⲱⲧ	ϩⲓⲙⲉ	1
ⲛ ϣⲁϫⲉ ⲉⲧ ⲟⲩⲁⲁⲃ ⲛⲧⲉ ⲡⲉⲛ ϫⲟⲉⲓⲥ ⲓⲏⲥⲟⲩⲥ	ϣⲁϫⲉ	1
ⲟⲩ ϣⲁϫⲉ ⲉⲣⲟ ⲓ ⲁⲡⲁ ⲛ ⲟⲩϫⲁⲓ	ϣⲁϫⲉ	1
ⲧⲉ ϣⲉⲉⲣⲉ	ϣⲉⲉⲣⲉ	1
ⲟⲩ ⲛⲁϩⲏⲧ	ⲛⲁϩⲏⲧ	1
ⲡ ⲉⲧ ⲟ ⲛ ⲣⲉϥϣⲟⲟⲣ	ⲡ	1
ⲟⲩ ⲥⲃⲱ ⲛ ⲃⲣⲣⲉ	ⲥⲃⲱ	1
ⲧ ⲙⲛⲧⲥⲟϭ ⲙ ⲡ ⲧⲁϣⲉⲟⲉⲓϣ	ⲙⲛⲧⲥⲟϭ	1
ⲧ ⲥⲟⲫⲓⲁ ⲙ ⲡ ⲛⲟⲩⲧⲉ	ⲥⲟⲫⲓⲁ	1
ⲧⲉⲩ ⲙⲛⲧⲁⲧⲛⲁϩⲧⲉ	ⲙⲛⲧⲁⲧⲛⲁϩⲧⲉ	1
ⲡ ⲙⲁ ⲉⲧⲉⲣⲉ ⲧ ϣⲉⲉⲣⲉ ϣⲏⲙ ⲛϩⲏⲧ ϥ	ⲙⲁ	1
ⲡⲉ ϩⲕⲟ	ϩⲕⲟ	1
ⲧ ⲙⲛⲧⲣⲙⲙⲁⲟ	ⲙⲛⲧⲣⲙⲙⲁⲟ	1
ⲛⲓⲙ ⲅⲁⲣ ⲛ ⲣⲱⲙⲉ	ⲛⲓⲙ	1
ⲡ ϣⲁϫⲉ ⲛ ⲛ ⲉⲩⲁⲅⲅⲉⲗⲓⲟⲛ ⲙ ⲡⲉⲛ ϫⲟⲉⲓⲥ ⲓⲏⲥⲟⲩⲥ ⲡⲉ ⲭⲣⲓⲥⲧⲟⲥ	ϣⲁϫⲉ	1
ⲡ ⲧⲣⲉ ⲧⲛ ⲕⲁⲙⲁ ⲛⲁ ϥ ⲛϩⲏⲧ ⲧⲏⲩⲧⲛ	ⲧⲣⲉ	1
ⲡ ϩⲁⲙϣⲉ ⲡ ϣⲏⲣⲉ ⲙ ⲙⲁⲣⲓⲁ . ⲁⲩⲱ ⲡ ⲥⲟⲛ ⲛ ⲓⲁⲕⲱⲃⲟⲥ ⲛⲙ ⲓⲱⲥⲏ ⲛⲙ ⲓⲟⲩⲇⲁ ⲛⲙ ⲥⲓⲙⲱⲛ	ϩⲁⲙϣⲉ	1
ⲡ ⲉⲧ ϫⲱ ⲛ ⲛⲁⲓ	ⲡ	1
ⲡ ⲉⲧ ⲁϩⲉ ⲣⲁⲧ ϥ	ⲡ	1
ⲡ ⲕⲟⲟϩ · ⲛ ⲧⲟⲟⲩ	ⲕⲟⲟϩ	1
ⲛ ⲉⲧⲉ ⲙⲛ ϭⲟⲙ ⲙⲙⲟ ⲟⲩ	ⲛ	1
ϣⲉⲉⲣⲉ ϣⲏⲙ ⲙ ⲙⲱⲁⲃⲓⲧⲏⲥ ⲧ ⲉⲛⲧ ⲁ ⲥ ⲕⲧⲟ ⲥ ⲙⲛ ⲛⲟⲉⲙⲓⲛ ⲉⲃⲟⲗ ϩⲛ ⲧ ⲥⲱϣⲉ ⲙ ⲙⲱⲁⲃ	ϣⲉⲉⲣⲉ	1
ⲡ ⲙⲁ ⲛ ⲛ ⲧⲱⲧⲉ	ⲙⲁ	1
ⲡ ϩⲟ ⲛ ⲛ ⲃⲁⲣⲃⲁⲣⲟⲥ	ϩⲟ	1
ⲡ ⲉⲧⲉ ⲟⲩⲛ ϭⲟⲙ ⲙⲙⲟ ⲕ ⲉ ⲁⲁ ϥ	ⲡ	1
ⲡⲉⲧⲛ ϭⲙ ⲡ ϣⲓⲛⲉ	ϭⲙ	1
ⲡ ⲉⲛⲧ ⲁ ϥ ⲧⲣⲉ ⲧⲉⲛ ⲯⲩⲭⲏ ⲣϩⲩⲙⲉⲣⲟⲥ	ⲡ	1
ϣⲉ ϫⲟⲩⲱⲧ ⲛ ⲕⲉⲛⲧⲏⲛⲁⲣⲓⲟⲛ ⲛ ⲛⲟⲩⲃ	ⲕⲉⲛⲧⲏⲛⲁⲣⲓⲟⲛ	1
ⲡ ⲉⲛⲧ ⲁ ⲩ ϫⲟⲟ ϥ ⲛ ⲁⲃⲣⲁϩⲁⲙ ⲉⲃⲟⲗ ϩⲓⲧⲙ ⲡ ⲛⲟⲩⲧⲉ	ⲡ	1
ⲟⲩ ϩⲟⲟⲩ ⲇⲉ ⲛ ⲣⲁⲛ	ϩⲟⲟⲩ	1
ⲛ ⲧⲉⲗⲓⲟⲥ	ⲧⲉⲗⲓⲟⲥ	1
ⲡ ϫⲟⲉⲓⲥ ⲡⲉⲩ ⲛⲟⲩⲧⲉ	ϫⲟⲉⲓⲥ	1
ⲛⲉⲛ ⲛⲏⲥⲧⲉⲓⲁ	ⲛⲏⲥⲧⲉⲓⲁ	1
ⲡ ⲥⲟⲃⲧⲉ ⲛ ⲧⲉⲩ ⲙⲛⲧϩⲏⲕⲉ	ⲥⲟⲃⲧⲉ	1
ⲥϩⲃⲏⲏⲧⲉ	ⲥϩⲃⲏⲏⲧⲉ	1
ⲟⲩ ⲑⲗⲓⲯⲓⲥ ϩⲛ ⲧ ⲥⲁⲣⲝ	ⲑⲗⲓⲯⲓⲥ	1
ⲡ ϫⲓϩⲣⲁϥ ⲛ ⲛ ⲃⲁⲗ	ϫⲓϩⲣⲁϥ	1
ⲡⲁⲙⲃⲱ ⲡⲉ ⲡⲣⲉⲥⲃⲩⲧⲉⲣⲟⲥ ⲛ ⲧ ⲉⲕⲕⲗⲏⲥⲓⲁ ⲛ ϣⲓⲏⲧ ⲡ ⲛⲟϭ ⲛ ϫⲟⲓ ⲉⲧ ⲣϩⲱⲧ ϩⲙ ⲡ ϫⲁⲓⲉ ⲛ ⲁⲧⲙⲟⲟⲩ	ⲡⲁⲙⲃⲱ	1
ⲡⲁⲓ ⲉⲧ ϫⲱ ⲙⲙⲟ ⲥ	ⲡⲁⲓ	1
ⲡ ⲉⲧ ⲙⲟⲕϩ ⲛ ϩⲏⲧ	ⲡ	1
ⲡ ⲙⲁ ⲉⲧⲉ ⲙⲛ ⲛⲟⲩϥⲉ ⲛϩⲏⲧ ϥ ⲟⲩⲇⲉ ⲭⲣⲏⲙⲁ	ⲙⲁ	1
ⲛⲉⲧⲛ ϫⲓϫⲉⲉⲩⲉ	ϫⲓϫⲉⲉⲩⲉ	1
ⲙϩⲁⲁⲩ	ⲙϩⲁⲁⲩ	1
ⲡ ⲉⲛⲧ ⲁ ϥ ⲧⲣⲉ ⲩ ⲥⲟⲩⲱⲛ ϥ · ⲉⲃⲟⲗ ϩⲓⲧⲛ ⲣⲱⲙⲉ ⲛⲓⲙ ⲛ ⲗⲟⲅⲓⲕⲟⲛ ⲙⲛ ⲍⲱⲟⲛ ⲛⲓⲙ	ⲡ	1
ⲡ ϩⲓⲕⲁⲛⲟⲥ ⲙ ⲡ ⲇⲩⲛⲁⲧⲟⲥ	ϩⲓⲕⲁⲛⲟⲥ	1
ⲛ ⲥⲉⲗⲓⲥ ⲙ ⲡ ϫⲱⲱⲙⲉ ⲛ ⲛ ϣⲁϫⲉ ⲛⲧ ⲁ ⲛⲉ ⲡⲣⲟⲫⲏⲧⲏⲥ ϫⲟⲟⲩ ⲥⲉ ⲛⲁ ⲩ ϩⲙ ⲡ ⲣⲁⲛ ⲙ ⲡ ⲛⲟⲩⲧⲉ	ⲥⲉⲗⲓⲥ	1
ⲡ ⲟⲩⲏⲏⲃ	ⲟⲩⲏⲏⲃ	1
ⲡ ⲟⲩⲣⲟⲧ	ⲟⲩⲣⲟⲧ	1
ⲡ ϣⲁϫⲉ · ⲛⲧ ⲁ ⲡ ϫⲟⲉⲓⲥ ϫⲟⲟ ϥ ⲙ ⲡⲉⲧⲣⲟⲥ	ϣⲁϫⲉ	1
ⲡⲁ ϣⲏⲣⲉ ⲡⲁ ⲙⲉⲣⲓⲧ ⲉⲛⲧ ⲁ ⲡⲁ ⲟⲩⲱϣ ϣⲱⲡⲉ ⲛϩⲏⲧ ⲕ	ϣⲏⲣⲉ	1
ⲡ ⲛⲟⲩⲧⲉ ⲡ ⲉⲛⲧ ⲁ ϥ ⲥⲱⲧⲡ ⲙⲙⲟ ⲓ ⲛⲁ ϥ · ⲉ ⲩ ⲙⲛⲧⲁⲡⲟⲥⲧⲟⲗⲟⲥ ⲛ ⲛ ϩⲉⲑⲛⲟⲥ	ⲛⲟⲩⲧⲉ	1
ⲡ ⲉⲧ ⲛⲁ ϣ ⲕⲁⲛⲟⲃⲉ ⲉⲃⲟⲗ	ⲡ	1
ⲡ ϭⲓⲥ ⲧⲃⲁ ⲛ ⲣⲱⲙⲉ	ⲣⲱⲙⲉ	1
ⲙⲏⲏϣⲉ ⲛ ⲧⲁⲅⲙⲁ ⲛ ⲁⲅⲅⲉⲗⲟⲥ ⲉ ⲙⲛ ⲏⲡ	ⲙⲏⲏϣⲉ	1
ⲡⲉ ⲑⲁⲃ ⲛ ϩⲏⲣⲱⲇⲏⲥ	ⲑⲁⲃ	1
ⲛ ⲣⲉϥϯ ⲛ ⲛ ϩⲏⲕⲉ	ⲣⲉϥϯ	1
ⲛ ⲙⲟⲩ ⲛ ⲉⲓⲟⲟⲩⲉ	ⲙⲟⲩ	1
ⲡ ⲉⲧ ⲣ ⲡ ⲉⲧ ⲛⲁⲛⲟⲩ ϥ ⲛ ⲛ ⲉⲧ ϣⲁⲁⲧ ⲉⲃⲟⲗ ϩⲛ ϩⲉⲛ ϩⲏⲩ ⲛϭⲓ ϫⲓⲛϭⲟⲛⲥ	ⲡ	1
ⲧ ϩⲟⲧⲉ ⲉⲧ ϣⲟⲟⲡ ⲛⲁ ⲕ ⲉϩⲟⲩⲛ ⲉ ⲡ ⲛⲟⲩⲧⲉ	ϩⲟⲧⲉ	1
ⲧ ⲙⲛⲧⲥⲧⲙⲏⲧ	ⲙⲛⲧⲥⲧⲙⲏⲧ	1
ϩⲣⲟⲩⲑ ⲇⲉ ⲧ ⲙⲱⲁⲃⲓⲧⲏⲥ	ϩⲣⲟⲩⲑ	1
ϩⲉⲛ ⲛⲩⲕⲧⲉⲣⲓⲥ	ⲛⲩⲕⲧⲉⲣⲓⲥ	1
ⲛ ϣⲁ ⲉⲛⲉϩ	ⲉⲛⲉϩ	1
ⲡⲉⲓⲣⲁⲥⲙⲟⲥ ⲛⲓⲙ	ⲡⲉⲓⲣⲁⲥⲙⲟⲥ	1
ⲡ ⲡⲁⲡⲁⲥ	ⲡⲁⲡⲁⲥ	1
ⲡⲉ ⲡⲛⲉⲩⲙⲁ ⲉⲧ ⲟⲩⲁⲁⲃ · ⲛ ⲣⲉϥⲧⲁⲛϩⲟ ⲙ ⲡ ⲧⲏⲣϥ · ⲁⲩⲱ ⲛ ϩⲟⲙⲟⲟⲩⲥⲓⲟⲛ	ⲡⲛⲉⲩⲙⲁ	1
ⲡ ⲁϣⲁⲓ ⲙ ⲡⲉ ⲙⲕⲁϩ ⲛ ϩⲏⲧ	ⲁϣⲁⲓ	1
ⲥⲁⲃⲃⲁⲧⲟⲛ	ⲥⲁⲃⲃⲁⲧⲟⲛ	1
ⲡ ⲙⲁ ⲉⲧ ⲟⲩ ⲣⲟⲉⲓⲥ ⲛϩⲏⲧ ϥ	ⲙⲁ	1
ⲟⲩ ⲥⲟⲟⲩϩⲥ ⲙ ⲙⲟⲛⲁⲭⲟⲥ	ⲥⲟⲟⲩϩⲥ	1
ⲥⲉⲛⲟⲩⲑⲓⲟⲩ ⲉⲡⲓⲥⲧⲟⲗⲏ	ⲉⲡⲓⲥⲧⲟⲗⲏ	1
ⲛⲉⲛ ⲃⲟⲩϩⲉ	ⲃⲟⲩϩⲉ	1
ⲛ ⲥⲙⲙⲉ ⲛ ⲛⲉⲧⲛ ⲉⲓⲟⲧⲉ	ⲥⲙⲙⲉ	1
ⲧ ⲙⲉϩⲥⲛⲧⲉ	ⲙⲉϩⲥⲛⲧⲉ	1
ⲡⲉ ϩⲟⲟⲩ ⲇⲉ ⲛ ⲧ ⲕⲩⲣⲓⲁⲕⲏ	ϩⲟⲟⲩ	1
ⲡⲁ ⲙⲟⲩ	ⲙⲟⲩ	1
ⲡⲁ ⲧⲱϣ	ⲧⲱϣ	1
ⲡⲁ ⲟⲩⲁ	ⲟⲩⲁ	1
ⲡⲁ ⲥⲟⲛ	ⲥⲟⲛ	1
ⲧ ⲙⲛⲧⲣⲙⲙⲁⲟ ⲛ ⲁⲧⲧⲁⲕⲟ	ⲙⲛⲧⲣⲙⲙⲁⲟ	1
ⲧⲉ ⲥϩⲓⲙⲉ ⲉⲧ ⲙⲙⲁⲩ	ⲥϩⲓⲙⲉ	1
ⲡ ⲡⲓⲛⲁⲝ	ⲡⲓⲛⲁⲝ	1
ⲡⲉ ϩⲟⲟⲩ ⲙ ⲡ ϩⲁⲡ ⲙ ⲙⲉ	ϩⲟⲟⲩ	1
ⲗⲁⲁⲩ ⲛ ϩⲛⲁⲁⲩ	ⲗⲁⲁⲩ	1
ⲧⲁⲗⲉⲓⲑⲁ	ⲧⲁⲗⲉⲓⲑⲁ	1
ⲕⲉ ⲥⲱϣⲉ	ⲥⲱϣⲉ	1
ⲟⲩ ϭⲟⲙ ⲛⲁ ⲩ ⲛⲧⲉ ⲡ ⲛⲟⲩⲧⲉ	ϭⲟⲙ	1
ⲛⲉϥ ϫⲓϫⲉⲉⲩⲉ	ϫⲓϫⲉⲉⲩⲉ	1
ϩⲉⲛ ⲁⲡⲟⲧ ⲉ ϩⲟⲣⲡ ⲟⲩ	ⲁⲡⲟⲧ	1
ⲡ ⲉⲧⲉⲣⲉ ⲡⲉϥ ϩⲱⲃ ⲛⲁ ϭⲱ ⲡⲁⲓ ⲉⲛⲧ ⲁ ϥ ⲕⲟⲧ ϥ	ⲡ	1
ⲕⲉ ⲥⲛⲧⲉ	ⲥⲛⲧⲉ	1
ⲡ ⲉⲛⲧ ⲁ ϥ ⲟⲩⲱⲛ ⲙ ⲡⲁ ϩⲏⲧ ϩⲛ ⲧⲁ ⲙⲉϩϣⲟⲙⲧⲉ ⲛ ⲣⲟⲙⲡⲉ	ⲡ	1
ⲡⲉ ⲙⲕⲁϩ ⲛ ϩⲏⲧ	ⲙⲕⲁϩ	1
ⲧ ϭⲓⲛϣⲁϫⲉ	ϭⲓⲛϣⲁϫⲉ	1
ⲡⲉⲧⲛ ⲉⲓⲱⲧ ⲉⲧ ϩⲛ ⲙ ⲡⲏⲩⲉ	ⲉⲓⲱⲧ	1
ⲛ ϣⲏⲣⲉ ⲙ ⲡ ⲛⲟⲩⲧⲉ	ϣⲏⲣⲉ	1
ⲓⲱϩⲁⲛⲛⲏⲥ ⲡ ⲥⲟⲛ ⲛ ⲓⲁⲕⲱⲃⲟⲥ	ⲓⲱϩⲁⲛⲛⲏⲥ	1
ⲡ ⲡⲁⲧⲣⲓⲁⲣⲭⲏⲥ · ⲓⲁⲕⲱⲃ	ⲓⲁⲕⲱⲃ	1
ⲩ ⲕⲟⲗⲟⲃⲓⲟⲛ · ⲉ ϥ ⲁϣⲉ ⲉϩⲣⲁⲓ	ⲕⲟⲗⲟⲃⲓⲟⲛ	1
ⲟⲩ ⲙⲛⲧϫⲁⲥⲓϩⲏⲧ	ⲙⲛⲧϫⲁⲥⲓϩⲏⲧ	1
ⲡ ⲙⲁ ⲉⲧⲉ ⲙⲛ ⲟⲩ ϣⲥ ⲛ ⲧⲁϭⲥⲉ ⲛϩⲏⲧ ϥ ⲙ ⲙⲛⲧⲣⲉϥϣⲙϣⲉⲛⲟⲩⲧⲉ	ⲙⲁ	1
ⲡ ⲛⲟⲩⲧⲉ ⲡⲉⲛ ⲉⲓⲱⲧ	ⲛⲟⲩⲧⲉ	1
ⲧ ⲙⲉⲥⲟⲡⲟⲧⲁⲙⲓⲁ ⲛ ⲧ ⲥⲩⲣⲓⲁ	ⲙⲉⲥⲟⲡⲟⲧⲁⲙⲓⲁ	1
ⲧ ⲁⲛⲁⲥⲧⲁⲥⲓⲥ	ⲁⲛⲁⲥⲧⲁⲥⲓⲥ	1
ⲧ ϭⲓⲛϣⲱⲗⲙ	ϭⲓⲛϣⲱⲗⲙ	1
ⲧⲁⲉⲓⲟⲩ ⲧⲁⲉⲓⲟⲩ	ⲧⲁⲉⲓⲟⲩ	1
ϫⲡ ϣⲟⲙⲧⲉ ⲙ ⲡⲉ ϩⲟⲟⲩ	ϫⲡ	1
ⲟⲩ ⲟⲉⲓⲕ ⲟⲩⲱⲧ	ⲟⲉⲓⲕ	1
ⲛ ⲕⲟⲟⲩⲉ ⲧⲏⲣ ⲟⲩ	ⲕⲟⲟⲩⲉ	1
ⲙⲛⲧⲥⲛⲟⲟⲩⲥ ⲛ ϣⲉ ⲛ ⲟⲉⲓⲕ	ϣⲉ	1
ⲟⲩ ⲕⲁⲕⲓⲁ	ⲕⲁⲕⲓⲁ	1
ϣⲧⲏⲛ ⲙ ⲡⲗϭⲉ	ϣⲧⲏⲛ	1
ⲡⲉⲕ ⲃⲁⲗ ⲥⲛⲁⲩ	ⲃⲁⲗ	1
ⲡ ⲕⲉ · ⲁⲡⲁ ϫⲓϫⲱⲓ	ϫⲓϫⲱⲓ	1
ⲛ ⲕⲟⲥⲙⲓⲕⲟⲛ	ⲕⲟⲥⲙⲓⲕⲟⲛ	1
ϣⲁϫⲉ ⲉ ϥ ϩⲟⲟⲩ	ϣⲁϫⲉ	1
ⲡ ⲥⲟⲟⲩⲧⲛ ⲙ ⲡⲉⲧⲛ ϩⲏⲧ	ⲥⲟⲟⲩⲧⲛ	1
ⲛ ⲉⲧⲉ ⲟⲩⲛⲧⲁ ⲩ ⲙⲙⲁⲩ ⲛ ⲟⲩ ⲭⲣⲏⲙⲁ · ⲟⲩ ⲛⲟⲩⲃ ⲙⲛ ⲟⲩ ϩⲁⲧ ⲙⲛ ϩⲉⲛ ϩⲩⲡⲁⲣⲭⲟⲛⲧⲁ	ⲛ	1
ⲟⲩ ⲟⲩϩⲟⲣ	ⲟⲩϩⲟⲣ	1
ⲟⲩ ⲟⲩϫⲁⲓ	ⲟⲩϫⲁⲓ	1
ⲡⲁ ⲙⲉⲣⲓⲧ ⲛ ⲥⲟⲛ ⲡⲁ ⲧⲉ ϣⲧⲏⲛ ⲛ ⲁⲩⲁⲛ ⲁⲩⲁⲛ ⲛ ⲧ ϩⲉ ⲛ ⲧⲉ ϣⲧⲏⲛ · ⲛ ⲓⲱⲥⲏⲫ ⲡ ⲇⲓⲕⲁⲓⲟⲥ	ⲙⲉⲣⲓⲧ	1
ⲧⲏⲩ ⲛⲓⲙ	ⲧⲏⲩ	1
ⲡⲟⲩ ϩⲏⲧ ⲅⲁⲣ ⲛ ⲁⲧⲥⲃⲱ	ϩⲏⲧ	1
ⲡⲉϥ ⲥⲧⲁⲩⲣⲟⲥ	ⲥⲧⲁⲩⲣⲟⲥ	1
ⲡ ⲣⲙⲛⲁⲥ	ⲣⲙⲛⲁⲥ	1
ⲧⲉⲧⲛ ⲇⲓⲕⲁⲓⲟⲥⲩⲛⲏ ⲛ ϩⲟⲩⲉ	ⲇⲓⲕⲁⲓⲟⲥⲩⲛⲏ	1
ⲛⲉ ϩⲃⲏⲩⲉ ⲉⲧ ⲟϣ	ϩⲃⲏⲩⲉ	1
ⲡ ⲉⲧ ⲧⲱϭⲉ ⲙⲙⲟ ϥ ⲉ ⲧ ⲡⲟⲣⲛⲏ	ⲡ	1
ⲧ ⲙⲏⲧⲉ ⲛ ⲛⲉ ⲕⲛⲁⲁⲩ	ⲙⲏⲧⲉ	1
ⲙ ⲙⲟⲕⲙⲉⲕ ⲛ ⲛ ⲥⲟⲫⲟⲥ	ⲙⲟⲕⲙⲉⲕ	1
ⲡ ⲙⲁ ⲉⲧⲉⲣⲉ ⲛ ϣⲏⲣⲉ ϣⲏⲙ ⲛⲁ ⲙⲉϩⲙⲟⲟⲩ ⲉⲣⲟ ϥ	ⲙⲁ	1
ϩⲱⲃ ⲇⲉ ⲛⲓⲙ	ϩⲱⲃ	1
ⲟⲩ ⲛⲟϭ ⲛ ⲛⲁⲩ	ⲛⲁⲩ	1
ⲕⲉ ⲗⲁⲁⲩ ⲛⲙⲙⲁ ⲩ	ⲗⲁⲁⲩ	1
ⲕⲁⲡⲁⲣⲛⲁⲟⲩⲙ	ⲕⲁⲡⲁⲣⲛⲁⲟⲩⲙ	1
ⲧ ϩⲩⲡⲟⲙⲟⲛⲏ	ϩⲩⲡⲟⲙⲟⲛⲏ	1
ⲡ ⲇⲓⲕⲁⲓⲟⲛ	ⲇⲓⲕⲁⲓⲟⲛ	1
ⲧ ⲙⲣⲣⲉ ⲙ ⲡⲉϥ ⲗⲁⲥ	ⲙⲣⲣⲉ	1
ⲡ ϫⲓⲟⲩⲉ ⲛ ⲟⲩ ϩⲁⲧ ⲙⲛ ⲟⲩ ⲛⲟⲩⲃ	ϫⲓⲟⲩⲉ	1
ⲡ ⲟⲉⲓⲕ ⲛ ⲛ ϣⲏⲣⲉ	ⲟⲉⲓⲕ	1
ⲡ ⲉⲧ ⲙⲓϣⲉ ⲉϫⲱ ⲕ	ⲡ	1
ⲛ ϣⲁϫⲉ ⲙ ⲡⲁⲓ ⲉⲧ ϫⲱ ⲛ ⲛⲁⲓ	ϣⲁϫⲉ	1
ⲣⲣⲟ ⲛⲧⲉ ⲡⲉⲓ ⲕⲟⲥⲙⲟⲥ	ⲣⲣⲟ	1
ⲛ ⲧⲟⲡⲟⲥ ⲉⲧ ϩⲓ ⲟⲩⲛⲁⲙ	ⲧⲟⲡⲟⲥ	1
ⲡ ⲉⲧ ⲕ ⲥⲟⲟⲩⲛ ⲙⲙⲟ ϥ ⲉⲧⲉ ⲡ ⲉⲧ ϣⲁϫⲉ ⲛⲙⲙⲁ ⲕ ⲡⲉ	ⲡ	1
ϩⲉⲛ ϣⲁϫⲉ ⲉ ⲩ ⲃⲟⲟⲛⲉ	ϣⲁϫⲉ	1
ⲡ ⲧⲣⲉ ⲩ ⲥⲱⲧⲙ ⲉⲣⲟ ⲓ	ⲧⲣⲉ	1
ⲛ ⲉⲧ ⲙⲟⲟⲛⲉ ⲇⲉ ⲙⲙⲟ ⲟⲩ	ⲛ	1
ⲡ ⲛⲁⲩ ⲙ ⲡ ⲁⲣⲓⲥⲧⲟⲛ	ⲛⲁⲩ	1
ⲡⲉ ⲡⲛⲉⲩⲙⲁ ⲙ ⲡ ⲣⲱⲙⲉ ⲉⲧ ⲛϩⲏⲧ ϥ	ⲡⲛⲉⲩⲙⲁ	1
ⲡ ⲛⲁⲏⲧ ⲛ ϣⲁⲛϩⲧⲏϥ · ⲡ ⲁⲧⲧⲱⲗⲙ · ⲡ ⲁⲧϫⲃⲓⲛ · ⲡ ⲁⲧⲧⲁϩⲟϥ · ⲡ ⲟⲩⲁ ⲙⲁⲩⲁⲁ ϥ · ⲡ ⲁⲧⲡⲱⲱⲛⲉ · ⲡ ⲁⲧⲕⲣⲟϥ · ⲡ ⲁⲧϭⲱⲛⲧ · ⲡ ⲣⲁⲛ ⲉⲧ ϩⲓϫⲛ ⲣⲁⲛ ⲛⲓⲙ	ⲛⲁⲏⲧ	1
ⲡⲁ ⲡⲛⲉⲩⲙⲁ	ⲡⲛⲉⲩⲙⲁ	1
ⲟⲩ ⲧⲣⲁⲡⲉⲍⲁ ⲛ ⲟⲩⲱⲧ	ⲧⲣⲁⲡⲉⲍⲁ	1
ⲡ ⲃⲁⲣⲟⲥ ⲉⲛⲧ ⲁ ⲩ ⲟⲩⲁϩ ϥ ⲉϫⲱ	ⲃⲁⲣⲟⲥ	1
ⲥⲧⲣⲁⲧⲏⲗⲁⲧⲏⲥ	ⲥⲧⲣⲁⲧⲏⲗⲁⲧⲏⲥ	1
ⲧ ⲙⲉⲣⲓⲥ ⲛ ⲧ ⲥⲱϣⲉ ⲛ ⲃⲟⲉⲥ ⲡⲉ ⲉⲃⲟⲗ ϩⲛ ⲧ ⲥⲩⲅⲅⲉⲛⲉⲓⲁ ⲛ ⲁⲃⲓⲙⲉⲗⲉⲭ	ⲙⲉⲣⲓⲥ	1
ⲧ ⲉⲕⲕⲗⲏⲥⲓⲁ ⲙ ⲡ ⲛⲟⲩⲧⲉ ⲧⲁⲓ ⲉⲧ ϣⲟⲟⲡ ϩⲛ ⲕⲟⲣⲓⲛⲑⲟⲥ	ⲉⲕⲕⲗⲏⲥⲓⲁ	1
ⲡ ϩⲱⲃ ⲉⲧ ⲟⲩⲟⲛϩ ⲉⲃⲟⲗ · ⲡⲁⲓ ⲉ ϣⲁ ⲩ ⲧⲁⲁ ϥ ϩⲙ ⲡ ⲥⲱⲙⲁ	ϩⲱⲃ	1
ⲟⲩ ⲙⲛⲧⲁⲙⲉⲗⲏⲥ	ⲙⲛⲧⲁⲙⲉⲗⲏⲥ	1
ⲡ ⲥⲉⲉⲡⲉ	ⲥⲉⲉⲡⲉ	1
ⲧⲉ ⲅⲣⲁⲫⲏ ⲧⲏⲣ ⲥ	ⲅⲣⲁⲫⲏ	1
ⲥⲟⲛ ⲥⲛⲁⲩ	ⲥⲟⲛ	1
ⲡⲉ ⲡⲣⲟⲫⲏⲧⲏⲥ	ⲡⲣⲟⲫⲏⲧⲏⲥ	1
ⲧⲉ ⲡⲣⲟⲑⲉⲥⲓⲥ	ⲡⲣⲟⲑⲉⲥⲓⲥ	1
ϣⲏⲣⲉ ⲙ ⲙⲉⲣⲓⲧ	ϣⲏⲣⲉ	1
ⲛ ⲉⲣⲏⲧ ⲛ ⲛ ⲉⲧ ⲥⲟⲩⲧⲱⲛ	ⲉⲣⲏⲧ	1
ⲡ ⲉⲧ ⲛⲏⲩ ⲇⲉ ⲉⲃⲟⲗ ⲙ ⲡ ⲣⲱⲙⲉ	ⲡ	1
ⲟⲩ ⲗⲟⲅⲭⲏ	ⲗⲟⲅⲭⲏ	1
ⲡ ⲥⲟⲉⲓⲧ	ⲥⲟⲉⲓⲧ	1
ⲧ ⲁⲑⲏⲧ	ⲁⲑⲏⲧ	1
ⲛ ⲓⲟⲩⲇⲁⲓ ⲇⲉ ⲉⲧ ⲧⲁϩⲙ	ⲓⲟⲩⲇⲁⲓ	1
ⲡ ⲁⲣⲏⲃ ⲛ ⲧⲉϥ ⲙⲛⲧⲣⲣⲟ	ⲁⲣⲏⲃ	1
ⲡ ⲁⲅⲁⲑⲟⲥ ⲛ ⲛⲟⲩⲧⲉ	ⲁⲅⲁⲑⲟⲥ	1
ⲡⲉϥ ⲧⲉⲗⲱⲛⲓⲟⲛ	ⲧⲉⲗⲱⲛⲓⲟⲛ	1
ⲙⲛⲧⲣⲉϥϣⲙϣⲉⲛⲟⲩⲧⲉ	ⲙⲛⲧⲣⲉϥϣⲙϣⲉⲛⲟⲩⲧⲉ	1
ⲧ ⲙⲛⲧⲥⲧⲣⲁⲧⲏⲗⲁⲧⲏⲥ	ⲙⲛⲧⲥⲧⲣⲁⲧⲏⲗⲁⲧⲏⲥ	1
ⲛ ϫⲓ ⲛ ϭⲟⲛⲥ	ϫⲓ	1
ⲡ ⲱϩⲥ ⲛ ⲛ ⲉⲓⲱⲧ ⲙⲛ ⲛⲉ ⲥⲟⲩⲟ	ⲱϩⲥ	1
ⲧ ⲁⲡⲟⲫⲁⲥⲓⲥ ⲙ ⲡ ⲁⲡⲟⲥⲧⲟⲗⲟⲥ	ⲁⲡⲟⲫⲁⲥⲓⲥ	1
ⲧⲉϥ ⲡⲁⲣⲟⲩⲥⲓⲁ ⲛ ⲁⲧⲡⲁⲣⲁⲓⲧⲉⲓ ⲙⲙⲟ ⲥ	ⲡⲁⲣⲟⲩⲥⲓⲁ	1
ⲧ ⲡⲁϣⲉ ⲛ ⲧⲁ ⲙⲛⲧⲣⲣⲟ	ⲡⲁϣⲉ	1
ⲧⲁⲉⲓⲟⲩ ⲛ ⲕⲉⲛⲧⲏⲛⲁⲣⲓⲟⲛ ⲛ ⲛⲟⲩⲃ	ⲕⲉⲛⲧⲏⲛⲁⲣⲓⲟⲛ	1
ⲡ ⲥⲱⲧⲏⲣ	ⲥⲱⲧⲏⲣ	1
ⲟⲩ ϫⲓⲥⲉ ⲁⲛ ⲛ ϣⲁϫⲉ ⲏ ⲛ ⲥⲟⲫⲓⲁ	ϫⲓⲥⲉ	1
ϩⲉⲛ ϣⲟϣⲟⲩ	ϣⲟϣⲟⲩ	1
ⲕⲟⲓⲛⲱⲛⲟⲥ ⲙⲛ ⲛⲉⲛ ⲉⲣⲏⲩ	ⲕⲟⲓⲛⲱⲛⲟⲥ	1
ⲡ ⲁϣⲁⲓ ⲙ ⲡ ⲣⲓⲙⲉ	ⲁϣⲁⲓ	1
ⲧ ⲧⲁⲡⲣⲟ ⲛ ⲛⲉ ⲥⲛⲏⲩ	ⲧⲁⲡⲣⲟ	1
ⲧⲁⲅⲙⲁ ⲛ ⲁⲅⲅⲉⲗⲟⲥ ⲉ ⲙⲛ ⲏⲡ	ⲧⲁⲅⲙⲁ	1
ⲡ ⲱⲃϣ ⲛ ⲛ ⲉⲛⲧⲟⲗⲏ ⲉⲛⲧ ⲁ ⲛⲉⲛ ⲉⲓⲟⲧⲉ ⲧⲁⲁ ⲩ ⲉⲧⲟⲟⲧ ⲛ	ⲱⲃϣ	1
ⲧ ⲙⲏⲧⲉ	ⲙⲏⲧⲉ	1
ⲥϣ ⲛ ⲧⲁϭⲥⲉ ⲛ ⲟⲩⲱⲧ ⲛⲧⲉ ⲛⲉϥ ⲟⲩⲉⲣⲏⲧⲉ	ⲥϣ	1
ⲧ ⲥⲏϥⲉ	ⲥⲏϥⲉ	1
ⲛⲉⲩ ϩⲃⲏⲩⲉ ⲉⲧ ϩⲟⲟⲩ	ϩⲃⲏⲩⲉ	1
ⲡ ⲉⲧ ϯ ⲛ ϩⲧⲏ ϥ ⲉⲣⲟ ⲟⲩ	ⲡ	1
ⲛⲁ ⲕⲉ ϣⲉⲉⲣⲉ ϣⲏⲙ	ϣⲉⲉⲣⲉ	1
ⲩ ⲛⲟϭ ⲛ ϫⲁⲙⲏ	ϫⲁⲙⲏ	1
ⲧ ⲡⲛⲛⲏ	ⲡⲛⲛⲏ	1
ⲡ ⲉⲧ ⲥⲁϣⲉ	ⲡ	1
ⲧ ⲙⲛⲧⲛⲟⲩⲧⲉ ⲙ ⲡ ⲛⲟⲩⲧⲉ	ⲙⲛⲧⲛⲟⲩⲧⲉ	1
ⲧ ⲕⲉⲥⲁⲣⲓⲁ ⲛⲧⲉ ⲫⲓⲗⲓⲡⲡⲟⲥ	ⲕⲉⲥⲁⲣⲓⲁ	1
ⲡ ϩⲙϩⲁⲗ ⲙ ⲡⲉ ⲭⲣⲓⲥⲧⲟⲥ	ϩⲙϩⲁⲗ	1
ϩⲛⲟ ⲛ ⲟⲩⲱⲙ	ϩⲛⲟ	1
ⲟⲩ ⲙⲉⲣⲓⲥ	ⲙⲉⲣⲓⲥ	1
ⲛⲉ ⲡⲛⲉⲩⲙⲁ ⲇⲉ ⲛ ⲁⲕⲁⲑⲁⲣⲧⲟⲛ	ⲡⲛⲉⲩⲙⲁ	1
ⲛ ⲁⲡⲁⲣⲭⲏ	ⲁⲡⲁⲣⲭⲏ	1
ⲡ ⲉⲧ ⲟⲩⲱϣ	ⲡ	1
ⲧ ⲙⲛⲧϭⲱⲃ ⲛⲧⲉ ⲡ ⲛⲟⲩⲧⲉ	ⲙⲛⲧϭⲱⲃ	1
ⲧ ⲗⲓⲧⲟⲩⲣⲅⲓⲁ ⲧⲉ ⲉⲃⲟⲗ ϩⲙ ⲡ ⲗⲟⲅⲟⲥ ⲙⲛ ⲡⲉ ⲡⲛⲉⲩⲙⲁ	ⲗⲓⲧⲟⲩⲣⲅⲓⲁ	1
ⲛⲉⲧⲛ ⲡⲣⲁⲝⲓⲥ	ⲡⲣⲁⲝⲓⲥ	1
ⲟⲩ ⲕⲟⲩⲓ ⲛⲏ ⲧⲛ	ⲕⲟⲩⲓ	1
ⲡⲁⲣⲙⲟⲩⲧⲉ	ⲡⲁⲣⲙⲟⲩⲧⲉ	1
ⲡⲉ ⲙⲕⲁϩ ⲛ ϩⲏⲧ ⲛ ⲛ ⲉⲛⲧ ⲁ ⲩ ϯϭⲱⲛⲧ ⲙ ⲡ ⲛⲟⲩⲧⲉ ⲁⲩⲱ ⲁ ⲩ ⲗⲩⲡⲉⲓ ⲙ ⲡⲉϥ ⲡⲛⲉⲩⲙⲁ ⲉⲧ ⲟⲩⲁⲁⲃ	ⲙⲕⲁϩ	1
ⲡⲉϥ ⲛⲁ ⲙⲛ ⲛ ⲉⲧ ⲟⲛϩ	ⲛⲁ	1
ⲍⲱⲛⲧ ⲛⲓⲙ	ⲍⲱⲛⲧ	1
ⲁⲣⲉⲧⲏ ⲛⲓⲙ	ⲁⲣⲉⲧⲏ	1
ⲧ ⲙⲉ · ⲡ ⲙⲧⲟⲛ · ⲡ ⲉⲟⲟⲩ · ⲧ ϭⲟⲙ ⲧ ⲉⲛⲧⲟⲗⲏ · ⲧ ⲡⲁⲣⲣⲏⲥⲓⲁ · ⲧ ⲙⲛⲧⲣⲙϩⲉ · ⲡⲉⲛ ⲙⲁ ⲙ ⲡⲱⲧ	ⲙⲉ	1
ⲡ ⲥⲟⲟⲩⲧⲛ ⲛ ⲍⲁⲭⲁⲓⲟⲥ	ⲥⲟⲟⲩⲧⲛ	1
ⲡ ϥⲛⲧ ⲛ ⲁⲧⲛⲕⲟⲧⲕ · ⲉⲧ ⲟⲩⲱⲙ ⲛⲥⲁ ⲧⲉ ⲯⲩⲭⲏ	ϥⲛⲧ	1
ⲟⲩ ⲙⲛⲧⲁⲥ	ⲙⲛⲧⲁⲥ	1
ⲟⲩ ⲙⲛⲧⲛⲁ	ⲙⲛⲧⲛⲁ	1
ⲡ ⲉⲧ ⲛⲁ ⲉⲓⲣⲉ ⲅⲁⲣ ⲙ ⲡ ⲟⲩⲱϣ ⲙ ⲡ ⲛⲟⲩⲧⲉ	ⲡ	1
ⲟⲩ ⲙⲟⲥⲧⲉ	ⲙⲟⲥⲧⲉ	1
ⲡⲓ ϣⲱϣ	ϣⲱϣ	1
ⲛⲓ ⲉⲥⲟⲟⲩ ⲉⲧ ⲟ ⲛ ϩⲟⲟⲗⲉ	ⲉⲥⲟⲟⲩ	1
ⲟⲩ ⲁⲅⲁⲑⲟⲛ ⲉ ϥ ϫⲏⲕ ⲉⲃⲟⲗ	ⲁⲅⲁⲑⲟⲛ	1
ⲡ ⲏⲓ ⲛ ⲥⲓⲙⲱⲛ ⲙⲛ ⲁⲛⲇⲣⲉⲁⲥ	ⲏⲓ	1
ⲧ ⲕⲟⲓⲛⲱⲛⲓⲁ ⲉⲧ ϣⲟⲟⲡ ϣⲁⲣⲟ ϥ	ⲕⲟⲓⲛⲱⲛⲓⲁ	1
ⲧ ⲙⲁⲕⲁⲣⲓⲁ ⲥⲩⲅⲕⲗⲏⲧⲓⲕⲏ	ⲥⲩⲅⲕⲗⲏⲧⲓⲕⲏ	1
ⲛ ⲁⲅⲅⲉⲗⲟⲥ ⲙ ⲡ ϫⲟⲉⲓⲥ	ⲁⲅⲅⲉⲗⲟⲥ	1
ⲛⲉϥ ϩⲃⲏⲩⲉ ⲙ ⲙⲛⲧⲣⲉϥϩⲉⲧⲃⲯⲩⲭⲏ	ϩⲃⲏⲩⲉ	1
ⲛ ⲉⲛⲧⲟⲗⲏ ⲉⲛⲧ ⲁ ⲛⲉⲛ ⲉⲓⲟⲧⲉ ⲧⲁⲁ ⲩ ⲉⲧⲟⲟⲧ ⲛ	ⲉⲛⲧⲟⲗⲏ	1
ⲡ ⲉⲧ ϣⲟⲩϣⲟⲩ ⲙⲙⲟ ϥ	ⲡ	1
ⲧ ϩⲁⲏ ⲛ ⲉⲛⲧⲟⲗⲏ · ⲉⲧⲉⲣⲉ ⲡ ⲣⲱⲙⲉ ⲛ ⲁⲁⲥ ⲙⲛ ⲡⲉϥ ⲥⲟⲛ	ϩⲁⲏ	1
ⲡⲉ ⲟⲩⲟⲉⲓϣ ⲛⲧ ⲁ ϥ ⲙⲟⲟϣⲉ	ⲟⲩⲟⲉⲓϣ	1
ⲡ ⲉⲧ ϩⲏⲛ ⲉϩⲟⲩⲛ ⲉ ⲡ ⲅⲉⲛⲟⲥ ⲉϩⲟⲩⲉⲣⲟ ⲓ	ⲡ	1
ϩⲉⲛ ϥⲱ ⲛ ϭⲁⲙⲟⲩⲗ	ϥⲱ	1
ⲧⲁ ⲙⲛⲧⲣⲣⲟ	ⲙⲛⲧⲣⲣⲟ	1
ϩⲁⲡ ⲙⲛ ⲛⲉⲧⲛ ⲉⲣⲏⲩ	ϩⲁⲡ	1
ⲛ ϣⲁϫⲉ ⲇⲉ ⲉⲧ ⲟⲩⲁⲁⲃ ⲛⲧⲉ ⲡⲉⲛ ϫⲟⲉⲓⲥ ⲓⲏⲥⲟⲩⲥ ⲉⲧ ⲥⲏϩ ϩⲛ ⲛⲉ ⲅⲣⲁⲫⲏ · ⲁⲩⲱ ϩⲛ ϯ ⲉⲡⲓⲥⲧⲟⲗⲏ	ϣⲁϫⲉ	1
ⲓⲏⲥⲟⲩⲥ ⲉⲧ ⲟⲩⲏϩ ϩⲛ ⲛⲉ ⲭⲣⲉⲓⲥⲧⲓⲁⲛⲟⲥ	ⲓⲏⲥⲟⲩⲥ	1
ϩⲉⲛ ⲟⲩⲟⲉⲓⲛ	ⲟⲩⲟⲉⲓⲛ	1
ⲛ ⲉⲧ ϩⲙ ⲡ ⲏⲓ ϩⲙ ⲡ ⲛⲟⲩⲧⲉ	ⲛ	1
ⲡⲉⲛ ⲉⲓⲱⲧ ϩⲏⲗⲓⲁⲥ ⲡⲉ ⲑⲉⲥⲃⲓⲧⲏⲥ	ϩⲏⲗⲓⲁⲥ	1
ⲛⲉⲓ ⲡⲁⲣⲧⲁⲗⲏⲥ	ⲡⲁⲣⲧⲁⲗⲏⲥ	1
ⲧⲓⲙⲟⲑⲉⲟⲥ ⲛⲏ ⲧⲛ ⲉⲧⲉ ⲡⲁⲓ ⲡⲉ ⲡⲁ ϣⲏⲣⲉ ⲙ ⲙⲉⲣⲓⲧ ⲁⲩⲱ ⲙ ⲡⲓⲥⲧⲟⲥ ϩⲙ ⲡ ϫⲟⲉⲓⲥ ⲡⲁⲓ ⲉⲧ ⲛⲁ ⲧⲣⲉ ⲧⲛ ⲣ ⲡ ⲙⲉⲉⲩⲉ ⲛ ⲛⲁ ϩⲓⲟⲟⲩⲉ ⲉⲧ ϩⲙ ⲡⲉ ⲭⲣⲓⲥⲧⲟⲥ ⲛ ⲧ ϩⲉ ⲉ ϯ ϯⲥⲃⲱ ⲙⲙⲟ ⲥ ϩⲛ ⲛ ⲉⲕⲕⲗⲏⲥⲓⲁ ⲧⲏⲣ ⲟⲩ ϩⲙ ⲙⲁ ⲛⲓⲙ	ⲧⲓⲙⲟⲑⲉⲟⲥ	1
ⲕⲉ ϥⲧⲟⲟⲩϣⲉ	ϥⲧⲟⲟⲩϣⲉ	1
ⲟⲩⲏⲣ ⲛ ϭⲟⲙ	ⲟⲩⲏⲣ	1
ϩⲱⲃ ⲛⲓⲙ ⲉⲛⲧ ⲁ ϥ ⲟⲩⲉϩⲥⲁϩⲛⲉ ⲙⲙⲟ ⲟⲩ	ϩⲱⲃ	1
ⲟⲩ ⲛⲟⲩϭⲥ	ⲛⲟⲩϭⲥ	1
ⲡ ⲣⲁⲛ ⲙ ⲡⲁⲩⲗⲟⲥ	ⲣⲁⲛ	1
ⲧⲁ ⲛ ⲁⲣⲭⲱⲛ ⲁⲛ ⲧⲉ ⲙ ⲡⲉⲓ ⲁⲓⲱⲛ ⲛⲁⲓ ⲉⲧ ⲛⲁ ⲟⲩⲱⲥϥ	ⲧⲁ	1
ⲡ ⲙⲁⲕⲁⲣⲓⲟⲥ ⲓⲱϩⲁⲛⲛⲏⲥ	ⲓⲱϩⲁⲛⲛⲏⲥ	1
ⲛ ⲉⲛⲧ ⲁ ⲡ ⲛⲟⲩⲧⲉ ⲭⲁⲣⲓⲍⲉ ⲙⲙⲟ ⲟⲩ	ⲛ	1
ⲛⲁ ⲛ ⲛ ⲣⲱⲙⲉ	ⲛⲁ	1
ϩⲉⲛ ⲕⲉ ⲉϫⲏⲩ	ⲉϫⲏⲩ	1
ⲡ ⲟⲩⲣⲟⲧ ⲉⲧ ⲛⲁϣⲱ ϥ	ⲟⲩⲣⲟⲧ	1
ⲟⲩ ⲙⲟⲛⲁⲭⲟⲥ	ⲙⲟⲛⲁⲭⲟⲥ	1
ⲡ ⲉ ϯ ⲛⲁ ϫⲟⲟ ϥ ⲛⲁ ⲕ	ⲡ	1
ⲡ ⲉⲧ ⲟ ϩⲱⲱ ϥ ⲛ ϣⲛⲁ	ⲡ	1
ⲧⲉⲕ ϭⲓⲛⲉⲓ ⲉϩⲟⲩⲛ ϩⲓⲧⲙ ⲡ ⲣⲟ	ϭⲓⲛⲉⲓ	1
ⲡ ⲥⲟⲟⲩⲛ ⲙ ⲡ ⲛⲟⲩⲧⲉ	ⲥⲟⲟⲩⲛ	1
ⲛ ⲁⲣⲭⲉⲟⲥ	ⲁⲣⲭⲉⲟⲥ	1
ⲩ ⲣⲱⲙⲉ ⲉ ⲩⲛ ϭⲟⲙ ⲙⲙⲟ ϥ ⲉ ⲧⲱⲟⲩⲛ ϩⲁ ⲡⲉϥ ⲙⲉⲉⲩⲉ ⲙⲁⲩⲁⲁ ϥ ϩⲛ ⲟⲩ ϩⲓⲥⲉ	ⲣⲱⲙⲉ	1
ⲗⲁⲁⲩ ⲛ ϣⲁϫⲉ	ⲗⲁⲁⲩ	1
ⲙⲏⲧ ⲛ ⲏⲓ ⲉⲣⲉ ⲙⲏⲧ ⲛ ⲥⲧⲉⲓⲱϩⲉ ⲉ ⲛ ⲟⲩⲁ ⲛϩⲏⲧ ⲟⲩ	ⲏⲓ	1
ⲛ ⲁⲥⲉⲃⲏⲥ	ⲁⲥⲉⲃⲏⲥ	1
ⲛ ⲉⲧ ⲙ ⲡⲁ ⲥⲁ ⲛϩⲟⲩⲛ ⲧⲏⲣ ⲟⲩ	ⲛ	1
ⲛⲁⲓ ϩⲓ ⲟⲩ ⲥⲟⲡ ⲉⲛⲧ ⲁ ⲩ ⲕⲉⲧ ⲡ ⲏⲓ ⲙ ⲡ ⲓⲥⲣⲁⲏⲗ	ⲛⲁⲓ	1
ⲧⲉⲕ ⲥϩⲓⲙⲉ ⲉⲧ ⲛⲁ ⲉⲓ ⲉϩⲟⲩⲛ ⲉ ⲡⲉⲕ ⲏⲓ	ⲥϩⲓⲙⲉ	1
ⲧⲉϥ ⲁⲛⲁⲡⲁⲩⲥⲓⲥ ⲉⲧ ϩⲁⲉⲟⲟⲩ	ⲁⲛⲁⲡⲁⲩⲥⲓⲥ	1
ⲡ ⲣⲡⲉ ⲡⲉ ⲙ ⲡⲉ ⲡⲛⲉⲩⲙⲁ ⲉⲧ ⲟⲩⲁⲁⲃ ⲉⲧ ⲛϩⲏⲧ ⲧⲏⲩⲧⲛ . ⲡⲁⲓ ⲉⲛⲧ ⲁ ⲧⲉⲧⲛ ϫⲓⲧ ϥ ⲉⲃⲟⲗ ϩⲓⲧⲙ ⲡ ⲛⲟⲩⲧⲉ	ⲣⲡⲉ	1
ⲛⲉⲛ ϣⲏⲣⲉ	ϣⲏⲣⲉ	1
ⲛⲉⲛ ϣⲗⲏⲗ	ϣⲗⲏⲗ	1
ⲙⲛⲧⲥⲛⲟⲟⲩⲥ ⲛ ⲣⲟⲙⲡⲉ	ⲣⲟⲙⲡⲉ	1
ⲧⲟⲩ ⲙⲁⲁⲩ ⲉⲧ ϩⲙ ⲡ ⲙⲁ ϩⲁⲧⲏ	ⲙⲁⲁⲩ	1
ⲗⲁⲁⲩ ⲛ ϩⲙⲟⲧ	ⲗⲁⲁⲩ	1
ⲛⲉⲓ ⲡⲉⲣⲓⲕⲁⲑⲁⲣⲙⲁ ⲙ ⲡ ⲕⲟⲥⲙⲟⲥ	ⲡⲉⲣⲓⲕⲁⲑⲁⲣⲙⲁ	1
ⲛⲉϥ ϩⲩⲡⲁⲣⲭⲟⲛⲧⲁ	ϩⲩⲡⲁⲣⲭⲟⲛⲧⲁ	1
ⲗⲁⲁⲩ ⲛ ϩⲩⲗⲏ	ⲗⲁⲁⲩ	1
ⲡ ⲉⲧ ⲓ ⲛⲁ ϭⲛⲭⲁⲣⲓⲥ ⲛⲛⲁϩⲣⲁ ϥ	ⲡ	1
ⲛⲓ ⲛⲟϭ ⲛ ϩⲓⲥⲉ ⲉⲧ ϩⲓϫⲙ ⲡ ⲕⲁϩ	ϩⲓⲥⲉ	1
ⲙ ⲙⲉⲉⲩⲉ ⲉⲧ ϩⲟⲟⲩ	ⲙⲉⲉⲩⲉ	1
ⲛ ⲉⲧ ϣⲱⲛⲉ	ⲛ	1
ⲩ ⲙⲛⲧⲙⲛⲧⲣⲉ	ⲙⲛⲧⲙⲛⲧⲣⲉ	1
ⲧ ⲙⲁⲁⲩ ⲛⲧ ⲁ ⲥ ϫⲡⲟ ϥ	ⲙⲁⲁⲩ	1
ⲟⲩ ⲉⲃⲟⲗ ϩⲙ ⲡ ⲅⲉⲛⲟⲥ ⲡⲉ ⲉⲧ ⲛⲁ ϫⲓⲧ ⲛ	ⲅⲉⲛⲟⲥ	1
ⲧ ⲕⲉ ⲉⲩⲭⲁⲣⲓⲥⲧⲓⲁ ⲉ ⲛ ⲛⲁ ⲟⲛⲟⲙⲁⲍⲉ ⲙⲙⲟ ⲟⲩ ⲉϫⲙ ⲡⲉⲓ ⲟⲉⲓⲕ ⲉ ⲛ ⲡⲱϣ ⲙⲙⲟ ϥ	ⲉⲩⲭⲁⲣⲓⲥⲧⲓⲁ	1
ⲕⲉ ϩⲉⲛⲉⲉⲧⲏ	ϩⲉⲛⲉⲉⲧⲏ	1
ⲡ ⲅⲉⲛⲛⲁⲓⲟⲥ ⲇⲉ ⲁⲡⲁ ⲃⲓⲕⲧⲱⲣ	ⲃⲓⲕⲧⲱⲣ	1
ⲡ ⲉⲧ ⲛⲁ ⲧⲥⲉ ⲧⲏⲛⲟⲩ ⲅⲁⲣ ⲛ ⲟⲩ ⲁⲡⲟⲧ ⲙ ⲙⲟⲟⲩ ϩⲙ ⲡⲁ ⲣⲁⲛ ϫⲉ ⲛⲧⲉⲧⲛ ⲛⲁ ⲡⲉ ⲭⲣⲓⲥⲧⲟⲥ	ⲡ	1
ⲛⲉ ϭⲗⲱϭ ⲛ ⲛ ⲉⲧ ⲙⲟⲕϩ ϩⲛ ⲛⲉⲩ ϣⲱⲛⲉ	ϭⲗⲱϭ	1
ⲧ ⲙⲛⲧⲛⲟϭ	ⲙⲛⲧⲛⲟϭ	1
ⲧⲉ ⲧⲓⲙⲏ ⲙ ⲡ ⲙⲁⲥⲉ	ⲧⲓⲙⲏ	1
ⲡ ⲕⲱⲧⲉ ⲧⲏⲣ ϥ ⲛ ⲧ ⲅⲁⲗⲓⲗⲁⲓⲁ	ⲕⲱⲧⲉ	1
ⲟⲩⲁ ⲉ ϥ ⲕⲏⲕⲁϩⲏⲩ	ⲟⲩⲁ	1
ⲧⲉ ϩⲓⲏ ⲙ ⲡ ϫⲟⲉⲓⲥ	ϩⲓⲏ	1
ⲧⲉ ⲕⲗⲏⲣⲟⲛⲟⲙⲓⲁ ⲛ ⲛⲉϥ ⲉⲓⲟⲧⲉ	ⲕⲗⲏⲣⲟⲛⲟⲙⲓⲁ	1
ⲡⲉ ⲭⲟⲣⲧⲟⲥ ⲉⲧ ⲟⲩⲉⲧⲟⲩⲱⲧ	ⲭⲟⲣⲧⲟⲥ	1
ⲛ ⲃⲁⲗ ⲙ ⲡ ⲥⲱⲙⲁ	ⲃⲁⲗ	1
ⲟⲉⲓⲕ ⲉ ⲟⲩⲱⲙ	ⲟⲉⲓⲕ	1
ⲡ ⲟⲣⲇⲓⲛⲟⲛ ⲙ ⲡⲉϥ ϣⲏⲣⲉ	ⲟⲣⲇⲓⲛⲟⲛ	1
ⲧⲟⲩ ⲡⲟⲗⲓⲥ	ⲡⲟⲗⲓⲥ	1
ⲛⲁ ⲁⲡⲟⲥⲧⲏⲑⲟⲥ	ⲁⲡⲟⲥⲧⲏⲑⲟⲥ	1
ⲧ ⲙⲛⲧⲣⲉϥⲣϩⲟⲧⲉ ⲙ ⲡ ⲉⲧ ⲙⲙⲁⲩ	ⲙⲛⲧⲣⲉϥⲣϩⲟⲧⲉ	1
ⲡ ⲙⲧⲟ ⲉⲃⲟⲗ ⲙ ⲡ ⲛⲟⲩⲧⲉ ⲓⲏⲥⲟⲩⲥ ⲡⲉ ⲭⲣⲓⲥⲧⲟⲥ	ⲙⲧⲟ	1
ϩⲉⲛ ⲛⲟϭ ⲛ ⲕⲗⲁⲇⲟⲥ	ⲕⲗⲁⲇⲟⲥ	1
ⲡ ⲉⲓⲱⲧ ⲛ ⲧ ϣⲉⲉⲣⲉ ϣⲏⲙ	ⲉⲓⲱⲧ	1
ⲡ ⲱⲕⲉⲁⲛⲟⲥ	ⲱⲕⲉⲁⲛⲟⲥ	1
ⲛ ⲕⲉ ⲡⲛⲉⲩⲙⲁ ⲛ ⲁⲕⲁⲑⲁⲣⲧⲟⲛ	ⲡⲛⲉⲩⲙⲁ	1
ⲧⲉ ϣⲧⲏⲛ ⲛ ⲁⲩⲁⲛ ⲁⲩⲁⲛ ⲛ ⲧ ϩⲉ ⲛ ⲧⲉ ϣⲧⲏⲛ · ⲛ ⲓⲱⲥⲏⲫ ⲡ ⲇⲓⲕⲁⲓⲟⲥ	ϣⲧⲏⲛ	1
ⲧ ϭⲟⲙ ⲙ ⲡⲉⲛ ϫⲟⲉⲓⲥ ⲓⲏⲥⲟⲩⲥ	ϭⲟⲙ	1
ⲡ ⲥⲟⲛ ⲉⲧ ⲙⲙⲁⲩ ϩⲛ ⲧⲉⲩ ⲙⲏⲏⲧⲉ	ⲙⲏⲏⲧⲉ	1
ⲟⲩ ⲡⲛⲉⲩⲙⲁ ⲛ ⲙⲡⲟ	ⲡⲛⲉⲩⲙⲁ	1
ⲡⲉⲛ ⲥⲟⲛ ⲧⲉ ⲁⲃⲓⲙⲉⲗⲉⲭ	ⲁⲃⲓⲙⲉⲗⲉⲭ	1
ⲁⲛⲟⲙⲓⲁ ⲛⲓⲙ	ⲁⲛⲟⲙⲓⲁ	1
ⲁⲡⲁ ϩⲓⲉⲣⲁⲝ · ⲡ ⲉⲛⲧ ⲁ ϥ ⲣϣⲃⲏⲣ ⲉ ⲛ ⲁⲅⲅⲉⲗⲟⲥ ⲙ ⲡ ⲛⲟⲩⲧⲉ ⲉⲧⲃⲉ ⲡⲉϥ ⲧⲃⲃⲟ	ϩⲓⲉⲣⲁⲝ	1
ⲡ ⲃⲟⲗ ⲙ ⲡ ⲥⲱⲙⲁ	ⲃⲟⲗ	1
ⲟⲩ ⲟⲩⲛⲟⲩ	ⲟⲩⲛⲟⲩ	1
ⲟⲩ ⲟⲩⲣⲟⲧ	ⲟⲩⲣⲟⲧ	1
ϩⲣⲟⲩⲑ ⲧⲉⲥ ϣⲉⲗⲉⲉⲧ	ϩⲣⲟⲩⲑ	1
ⲧⲉⲕ ⲁⲗⲱⲧ	ⲁⲗⲱⲧ	1
ⲛ ⲉⲧ ⲛⲏⲩ ⲛⲁ ⲛ ⲉϩⲟⲩⲛ ⲉⲃⲟⲗ	ⲛ	1
ⲛⲉⲩ ⲟⲩⲁⲙⲟⲙⲉ	ⲟⲩⲁⲙⲟⲙⲉ	1
ⲧ ⲉⲛⲧ ⲁ ⲥ ϣⲉⲡϣⲡ ⲧⲏⲩⲧⲛ ⲧ ϩⲓⲉⲣⲟⲩⲥⲁⲗⲏⲙ ⲉⲧⲉ ⲧ ⲥⲩⲛⲁⲅⲱⲅⲏ ⲧⲉ	ϩⲓⲉⲣⲟⲩⲥⲁⲗⲏⲙ	1
ⲡ ⲅⲉⲛⲟⲥ ⲛ ⲛ ⲣⲱⲙⲉ	ⲅⲉⲛⲟⲥ	1
ⲛ ⲉⲧ ⲙⲟⲟϣⲉ ⲛⲉ ϩⲛ ⲙⲛⲧⲁⲧⲥⲱⲧⲙ ⲛⲓⲙ ϩⲓ ⲙⲛⲧⲁⲧⲥⲃⲱ ⲛⲓⲙ	ⲛ	1
ⲛ ⲕⲉ ⲉⲥⲑⲏⲧⲏⲣⲓⲟⲛ ⲉⲧ ϩⲓϩⲟⲩⲛ	ⲉⲥⲑⲏⲧⲏⲣⲓⲟⲛ	1
ⲛ ϩⲣϣⲓⲣⲉ	ϩⲣϣⲓⲣⲉ	1
ⲥⲟⲫⲟⲥ ⲛ ⲁⲣⲭⲓⲧⲉⲕⲧⲱⲛ	ⲥⲟⲫⲟⲥ	1
ⲡ ⲃⲟⲗ ⲛ ⲧ ⲡⲩⲗⲏ ⲛ ⲧ ⲡⲟⲗⲓⲥ	ⲃⲟⲗ	1
ⲥⲟⲩⲙⲛⲧⲧⲁⲥⲉ ⲙ ⲡ ⲉⲃⲟⲧ ⲡⲁⲱⲛⲉ	ⲥⲟⲩⲙⲛⲧⲧⲁⲥⲉ	1
ⲧ ⲕⲟⲓⲛⲱⲛⲓⲁ ⲛ ⲛ ϣⲁ ⲉⲛⲉϩ	ⲕⲟⲓⲛⲱⲛⲓⲁ	1
ⲧⲉϥ ⲡⲣⲟⲛⲟⲓⲁ	ⲡⲣⲟⲛⲟⲓⲁ	1
ⲡ ⲉⲧⲉ ⲩⲛⲧⲁ ϥ ϥ	ⲡ	1
ⲧ ⲙⲛⲧⲁⲡⲁⲛⲑⲣⲟⲡⲟⲥ ⲉⲧ ϫⲓ ⲉϩⲟⲩⲛ ⲉ ⲛ ⲁⲧϭⲟⲙ	ⲙⲛⲧⲁⲡⲁⲛⲑⲣⲟⲡⲟⲥ	1
ⲟⲩ ⲙⲟⲣⲫⲏ ⲛ ϩⲙϩⲁⲗ	ⲙⲟⲣⲫⲏ	1
ⲟⲩ ⲡⲓⲛⲁⲝ	ⲡⲓⲛⲁⲝ	1
ⲡ ⲟⲩⲁ ⲡ ⲟⲩⲁ ⲛ ⲛⲉ ⲥⲛⲏⲩ	ⲟⲩⲁ	1
ⲛⲉⲛ ⲕⲉ ϩⲙϩⲁⲗ	ϩⲙϩⲁⲗ	1
ⲛⲉϥ ϣⲟϫⲛⲉ ⲛ ⲕⲣⲟϥ	ϣⲟϫⲛⲉ	1
ⲛ ⲣⲱⲙⲉ ⲉⲧ ϣⲱⲛⲉ ⲙⲙⲁⲧⲉ	ⲣⲱⲙⲉ	1
ⲡ ⲉⲧ ⲛⲁ ϫⲓ ϣⲁϫⲉ ⲉ ϥ ϩⲟⲟⲩ ⲛⲥⲁ ⲡⲉϥ ⲉⲓⲱⲧ ⲏ ⲧⲉϥ ⲙⲁⲁⲩ	ⲡ	1
ⲥⲓⲙⲱⲛ ⲡ ⲕⲁⲛⲁⲛⲁⲓⲟⲥ	ⲥⲓⲙⲱⲛ	1
ⲟⲩ ⲡⲗⲏⲅⲏ	ⲡⲗⲏⲅⲏ	1
ⲕⲟⲛϯⲧⲟⲛ	ⲕⲟⲛϯⲧⲟⲛ	1
ϣⲙⲟⲩⲛ ⲛⲧⲉ ⲑⲏⲃⲁⲓⲥ	ϣⲙⲟⲩⲛ	1
ⲡ ⲉⲛⲧ ⲁ ϥ ⲭⲁⲣⲓⲍⲉ ⲛⲁ ⲓ ⲛ ⲧⲉϥ ⲡⲓⲥⲧⲓⲥ ⲉ ⲛ ⲥ ⲡⲏϣ ⲁⲛ	ⲡ	1
ϣⲏⲧ ⲛ ⲕⲉⲛⲧⲏⲛⲁⲣⲓⲟⲛ ⲛ ⲛⲟⲩⲃ	ⲕⲉⲛⲧⲏⲛⲁⲣⲓⲟⲛ	1
ⲡ ϩⲓⲕⲁⲛⲟⲥ	ϩⲓⲕⲁⲛⲟⲥ	1
ⲡ ⲁⲣⲭⲱⲛ ⲛ ⲛ ⲇⲁⲓⲙⲱⲛⲓⲟⲛ	ⲁⲣⲭⲱⲛ	1
ⲧ ϭⲓⲛⲛⲁⲩ	ϭⲓⲛⲛⲁⲩ	1
ϩⲉⲛ ⲥⲛⲏⲩ ⲙ ⲙⲁⲓⲛⲟⲩⲧⲉ	ⲥⲛⲏⲩ	1
ⲛⲉⲕ ϩⲓⲥⲉ ⲙ ⲙⲉ	ϩⲓⲥⲉ	1
ⲛ ⲉⲧ ⲥⲟⲩⲧⲱⲛ	ⲛ	1
ⲛ ⲉⲧ ⲛⲏⲩ ⲉⲃⲟⲗ ⲙ ⲡ ⲣⲱⲙⲉ	ⲛ	1
ⲛ ⲉⲛⲧⲟⲗⲏ ⲧⲏⲣ ⲟⲩ ⲉⲧ ⲥⲏϩ	ⲉⲛⲧⲟⲗⲏ	1
ϩⲉⲛ ϩⲱⲃ ⲛⲧⲉ ⲡ ⲃⲓⲟⲥ	ϩⲱⲃ	1
ⲛ ⲟⲉⲓⲕ ⲛ ⲧⲉ ⲡⲣⲟⲑⲉⲥⲓⲥ	ⲟⲉⲓⲕ	1
ⲡⲉⲥ ϣⲏⲣⲉ ⲥⲛⲁⲩ	ϣⲏⲣⲉ	1
ⲕⲉ ⲡⲁⲣⲁⲃⲟⲗⲏ ⲧⲏⲣ ⲟⲩ	ⲡⲁⲣⲁⲃⲟⲗⲏ	1
ⲁⲗⲗⲟⲧⲣⲓⲟⲥ	ⲁⲗⲗⲟⲧⲣⲓⲟⲥ	1
ⲟⲩ ⲯⲩⲭⲓⲕⲟⲥ ⲇⲉ ⲛ ⲣⲱⲙⲉ	ⲯⲩⲭⲓⲕⲟⲥ	1
ⲡ ⲙⲁ ⲛⲧ ⲁ ϥ ⲃⲱⲕ ⲉ ⲡ ⲉⲥⲏⲧ ⲉⲣⲟ ϥ	ⲙⲁ	1
ⲡⲁⲣⲣⲏⲥⲓⲁ	ⲡⲁⲣⲣⲏⲥⲓⲁ	1
ⲥⲛⲁⲩ ⲥⲛⲁⲩ	ⲥⲛⲁⲩ	1
ⲧ ⲙⲛⲧⲣⲙⲣⲁϣ ⲙ ⲙⲱⲩⲥⲏⲥ	ⲙⲛⲧⲣⲙⲣⲁϣ	1
ⲡ ⲕⲉ ⲥⲉⲉⲡⲉ ⲛ ⲛ ⲛⲟϭ ⲉⲧ ϩⲙ ⲡ ⲡⲁⲗⲗⲁϯⲟⲛ	ⲥⲉⲉⲡⲉ	1
ⲡ ⲁϣⲁⲓ ⲛ ⲛⲁ ⲛⲟⲃⲉ	ⲁϣⲁⲓ	1
ⲛ ⲧⲟϣ ⲛ ⲧⲩⲣⲟⲥ	ⲧⲟϣ	1
ⲧ ⲙⲉ ⲧⲏⲣ ⲥ	ⲙⲉ	1
ⲧ ⲙⲛⲧⲧⲉⲗⲓⲟⲥ ⲉⲧ ⲛϩⲏⲧ ⲕ	ⲙⲛⲧⲧⲉⲗⲓⲟⲥ	1
ⲟⲩ ⲣⲱⲙⲉ ⲉ ϥ ⲛⲏⲩ ⲉⲃⲟⲗ ϩⲛ ⲛⲉ ⲙϩⲁⲟⲩ ⲉⲣⲉ ⲟⲩ ⲡⲛⲉⲩⲙⲁ ⲛ ⲁⲕⲁⲑⲁⲣⲧⲟⲛ ⲛⲙⲙⲁ ϥ	ⲣⲱⲙⲉ	1
ⲟⲩ ϣⲧⲏⲛ ⲛ ϩⲃⲟⲟⲥ	ϣⲧⲏⲛ	1
ⲛ ϣⲏⲣⲉ ⲙ ⲡ ⲟⲩⲟⲉⲓⲛ ⲉⲧⲉ ⲛ ⲉⲧ ⲙⲟⲟϣⲉ ⲛⲉ ϩⲛ ⲧ ⲡⲁⲣⲣⲏⲥⲓⲁ ⲛ ϩⲩⲡⲟⲧⲁⲅⲏ ⲛⲓⲙ ϩⲓ ⲙⲛⲧⲥⲧⲙⲏⲧ ⲛⲓⲙ ϩⲓ ϩⲱⲃ ⲛⲓⲙ ⲛ ⲁⲅⲁⲑⲟⲛ	ϣⲏⲣⲉ	1
ⲧⲟⲩ ϣⲃⲣϣⲉⲗⲉⲉⲧ	ϣⲃⲣϣⲉⲗⲉⲉⲧ	1
ⲟⲩ ⲙⲁ ⲛ ⲟⲩⲟⲉⲓⲉ ⲛⲧⲉ ⲡ ⲛⲟⲩⲧⲉ	ⲙⲁ	1
ϩⲉⲛ ϣⲟⲛⲧⲉ	ϣⲟⲛⲧⲉ	1
ⲡⲉϥ ϩⲱⲃ ⲛ ϭⲓϫ	ϩⲱⲃ	1
ⲩ ⲁⲡⲟⲗⲁⲩⲥⲓⲥ	ⲁⲡⲟⲗⲁⲩⲥⲓⲥ	1
ⲛⲟⲩ ⲉⲓⲟⲧⲉ ⲛ ⲃⲟⲗ ϩⲙ ⲡ ⲕⲟⲥⲙⲟⲥ	ⲉⲓⲟⲧⲉ	1
ⲟⲩ ⲣⲙⲙⲁⲟ	ⲣⲙⲙⲁⲟ	1
ⲛ ⲉⲛⲧ ⲁ ⲡⲉⲛ ⲉⲓⲱⲧ ϫⲟⲟ ⲩ	ⲛ	1
ⲛⲉϥ ⲙⲉⲣⲟⲥ	ⲙⲉⲣⲟⲥ	1
ⲧ ϩⲁⲓⲃⲉⲥ ⲛ ⲟⲩ ⲕⲱϩ ⲛ ⲧⲟⲟⲩ	ϩⲁⲓⲃⲉⲥ	1
ⲡⲓ ⲁⲣⲭⲓⲙⲁⲛⲇⲣⲓⲧⲏⲥ	ⲁⲣⲭⲓⲙⲁⲛⲇⲣⲓⲧⲏⲥ	1
ⲧ ⲙⲉⲣⲓⲥ ⲉⲧ ϩⲟⲣϭ	ⲙⲉⲣⲓⲥ	1
ⲛ ⲉⲧ ϫⲱ ⲛ ⲧ ⲙⲉ ⲛ ⲟⲩⲟⲉⲓϣ ⲛⲓⲙ	ⲛ	1
ⲟⲩ ⲡⲛⲉⲩⲙⲁ ⲛ ⲟⲩⲱⲧ	ⲡⲛⲉⲩⲙⲁ	1
ⲡ ⲉⲧ ⲓ ⲛⲁ ϫⲟⲟ ϥ	ⲡ	1
ⲟⲩ ⲣⲟⲟⲩⲉ	ⲣⲟⲟⲩⲉ	1
ⲡⲉ ϩⲟⲩⲟ ⲙ ⲡ ⲙⲏⲏϣⲉ ⲉⲧ ⲟⲩⲏϩ ⲛⲥⲱ ϥ	ϩⲟⲩⲟ	1
ⲛⲁ ⲁⲃⲓⲙⲉⲗⲉⲭ ⲧⲏⲣ ⲟⲩ	ⲛⲁ	1
ⲛ ⲉⲛⲧ ⲁ ⲩ ϫⲟⲟ ⲥ ⲉⲧⲃⲏⲏⲧ ⲟⲩ	ⲛ	1
ⲡ ⲁⲅⲁⲑⲟⲥ ⲛ ⲣⲱⲙⲉ ⲛⲧⲉ ⲡ ⲛⲟⲩⲧⲉ	ⲁⲅⲁⲑⲟⲥ	1
ⲧⲉⲧⲛ ⲙⲏⲧⲉ	ⲙⲏⲧⲉ	1
ⲧⲉⲧⲛ ϭⲓϫ	ϭⲓϫ	1
ϩⲃⲏⲩⲉ ⲉ ⲩ ⲟⲩⲁⲁⲃ	ϩⲃⲏⲩⲉ	1
ⲡ ⲣⲱⲙⲉ ⲉⲛⲧ ⲁ ϥ ⲉⲓⲣⲉ ⲛⲙⲙⲁ ⲓ ⲙ ⲡ ϩⲟⲟⲩ	ⲣⲱⲙⲉ	1
ⲛⲉ ϩⲃⲏⲩⲉ ⲉⲛⲧ ⲁ ⲁ ⲩ ⲙⲛ ⲧⲟⲩ ϣⲱⲙⲉ	ϩⲃⲏⲩⲉ	1
ⲛ ⲣⲙⲉⲓⲟⲟⲩⲉ	ⲣⲙⲉⲓⲟⲟⲩⲉ	1
ⲛ ⲉⲧ ϩⲙ ⲡⲉ ⲭⲣⲓⲥⲧⲟⲥ	ⲛ	1
ⲡ ⲥⲟⲫⲟⲥ ⲇⲉ ⲛⲧⲟϥ ⲉⲧ ⲙⲉ ⲛ ⲧⲉ ⲥⲃⲱ	ⲥⲟⲫⲟⲥ	1
ⲟⲩ ϣⲥ ⲛ ⲧⲁϭⲥⲉ ⲛϩⲏⲧ ϥ ⲙ ⲙⲛⲧⲣⲉϥϣⲙϣⲉⲛⲟⲩⲧⲉ	ϣⲥ	1
ⲟⲩ ⲕⲁⲧⲁⲕⲣⲓⲙⲁ ⲛⲁ ⲕ ⲛ ⲟⲩⲏⲣ	ⲕⲁⲧⲁⲕⲣⲓⲙⲁ	1
ⲛⲉϥ ⲙⲟⲉⲓⲧ	ⲙⲟⲉⲓⲧ	1
ⲡⲉ ⲥⲧⲟⲓ ⲙ ⲡ ⲗⲓⲃⲁⲛⲟⲥ	ⲥⲧⲟⲓ	1
ⲛⲟⲩ ⲕⲁϩ ⲛ ϣⲙⲙⲟ	ⲕⲁϩ	1
ⲡ ⲱⲛϩ ⲉⲧ ⲙⲏⲛ ⲉⲃⲟⲗ	ⲱⲛϩ	1
ⲡ ⲙⲉϩϥⲧⲟⲟⲩ ⲛ ϣⲱⲡ ⲛ ⲧⲉ ⲩϣⲏ	ⲙⲉϩϥⲧⲟⲟⲩ	1
ⲩ ⲣⲱⲙⲉ · ⲙ ⲡ ⲟⲩⲉ ⲉ ϥ ⲟ ⲛ ϩⲟⲧⲉ ⲉⲙⲁⲧⲉ · ⲉⲣⲉ ⲡⲉϥ ϥⲱ ⲡⲟⲣϣ ⲉⲃⲟⲗ · ⲉϫⲙ ⲡⲉϥ ⲥⲱⲙⲁ · ⲛ ⲧ ϩⲉ ⲙ ⲡⲁ ⲛⲉⲓ ⲡⲁⲣⲧⲁⲗⲏⲥ · ⲛ ϥ ⲕⲏⲕⲁϩⲏⲩ ⲅⲁⲣ ⲡⲉ · ⲉⲣⲉ ϩⲉⲛ ϭⲱⲱⲃⲉ ϩⲱⲃⲥ ⲙ ⲡⲉϥ ⲥⲙⲟⲧ ⲛ ϩⲟⲟⲩⲧ	ⲣⲱⲙⲉ	1
ⲡⲉⲓ ϣⲏⲛ	ϣⲏⲛ	1
ⲇⲁⲗⲙⲁⲛⲟⲩⲑⲁ	ⲇⲁⲗⲙⲁⲛⲟⲩⲑⲁ	1
ⲛ ⲉⲧ ⲟⲩ ⲕⲣⲓⲛⲉ ⲙⲙⲟ ⲟⲩ	ⲛ	1
ⲧ ϣⲉⲉⲣⲉ ⲛ ϩⲏⲣⲱⲇⲓⲁⲥ	ϣⲉⲉⲣⲉ	1
ϫⲁⲥⲓϩⲏⲧ ⲛ ⲃⲁⲃⲉⲣⲱⲙⲉ ⲛ ⲣⲉϥⲕⲱⲧⲉ ⲛⲥⲁ ⲡ ⲡⲉⲧϩⲟⲟⲩ	ϫⲁⲥⲓϩⲏⲧ	1
ⲡⲓ ⲕⲣⲟ	ⲕⲣⲟ	1
ⲡⲓ ⲛⲁⲩ	ⲛⲁⲩ	1
ⲡ ⲙⲁ ⲁⲛ ⲉⲧ ⲉ ⲛϩⲏⲧ ϥ	ⲙⲁ	1
ⲥⲟⲩϣⲙⲟⲩⲛ ⲙ ⲡ ⲉⲃⲟⲧ ⲉⲡⲏⲡ	ⲥⲟⲩϣⲙⲟⲩⲛ	1
ϩⲁⲓⲣⲉⲥⲓⲥ ⲛⲓⲙ	ϩⲁⲓⲣⲉⲥⲓⲥ	1
ⲡⲉϥ ⲁⲅⲱⲛ ⲉⲧ ⲧⲁⲓⲏⲩ	ⲁⲅⲱⲛ	1
ⲧ ⲁⲧⲥⲃⲱ ⲉⲧⲉ ⲙⲛ ⲥⲃⲱ ⲙⲙⲟ ⲥ	ⲁⲧⲥⲃⲱ	1
ⲛ ⲉⲧ ⲟⲩ ϫⲓ ⲙⲙⲟ ⲟⲩ ⲛ ϭⲟⲛⲥ ϫⲓⲛ ϫⲱ ϥ ⲙ ⲡ ⲕⲁϩ ϣⲁ ⲁⲣⲏϫ ⲥ ⲛ ⲧ ⲟⲓⲕⲟⲩⲙⲉⲛⲏ	ⲛ	1
ⲛ ⲙⲁ ⲛ ϩⲱⲧⲡ	ⲙⲁ	1
ⲩ ⲥⲟⲛ ⲛ ⲁⲛⲁⲭⲱⲣⲓⲧⲏⲥ ⲉ ⲡⲉϥ ⲣⲁⲛ ⲡⲉ ⲁⲡⲁ ⲡⲁⲡⲛⲟⲩⲧⲉ	ⲡⲁⲡⲛⲟⲩⲧⲉ	1
ⲡ ϣⲓⲕ ⲛⲧ ⲁ ⲩ ϣⲁⲕⲧ ϥ · ⲡ ⲙⲁ ⲉⲧⲉ ⲛⲉϥ ϩⲟⲓⲧⲉ ⲡⲟⲣϣ ⲛϩⲏⲧ ϥ	ϣⲓⲕ	1
ⲧ ⲁⲅⲉⲗⲏ ⲛ ⲣⲓⲣ	ⲁⲅⲉⲗⲏ	1
ⲛⲉⲧⲛ ⲡⲉⲧϩⲟⲟⲩ ⲧⲏⲣ ⲟⲩ	ⲡⲉⲧϩⲟⲟⲩ	1
ⲡ ⲣⲁⲛ ⲇⲉ ⲙ ⲡⲉϥ ϣⲏⲣⲉ ⲥⲛⲁⲩ	ⲣⲁⲛ	1
ⲛⲉ ϩⲙⲟⲧ	ϩⲙⲟⲧ	1
ⲛⲉ ϩⲟⲟⲩ	ϩⲟⲟⲩ	1
ⲟⲩⲁ ⲇⲉ ⲛⲧⲉ ⲛ ⲉⲧ ⲟⲩⲁⲁⲃ ⲉ ϣⲁ ⲩ ⲙⲟⲩⲧⲉ ⲉⲣⲟ ϥ ϫⲉ ⲫⲓⲗⲁⲅⲣⲓⲟⲥ · ⲉ ϥ ⲟⲩⲏϩ ϩⲛ ⲧ ϩⲓⲉⲣⲟⲩⲥⲁⲗⲏⲙ · ⲉ ϥ ⲣϩⲱⲃ ϩⲛ ⲟⲩ ϩⲓⲥⲉ · ϣⲁⲛⲧⲉ ϥ ϫⲡⲟ ⲛⲁ ϥ ⲙ ⲡⲉϥ ⲟⲉⲓⲕ ⲙⲙⲓⲛⲙⲙⲟ ϥ	ⲫⲓⲗⲁⲅⲣⲓⲟⲥ	1
ⲡ ⲉⲟⲟⲩ ⲙ ⲡⲉⲓ ⲙⲁ	ⲉⲟⲟⲩ	1
ⲡ ⲉⲧ ⲥⲕⲩⲡⲁⲍⲉ ⲛ ⲟⲩⲟⲛ ⲛⲓⲙ ⲉⲧ ϩⲉⲗⲡⲓⲍⲉ ⲉⲣⲟ ⲕ · ϩⲛ ⲛⲉⲕ ⲇⲱⲣⲉⲁ ⲙⲛ ⲛⲉⲕ ⲙⲛⲧⲛⲁ	ⲡ	1
ⲡ ⲁⲛⲁⲭⲱⲣⲏⲧⲏⲥ	ⲁⲛⲁⲭⲱⲣⲏⲧⲏⲥ	1
ⲟⲩ ⲥⲣⲁϩⲧ	ⲥⲣⲁϩⲧ	1
ϭⲉ	ϭⲉ	1
ⲗⲁⲁⲩ ⲛ ϩⲛⲁⲁⲩ ⲛ ⲧⲉⲓ ⲙⲓⲛⲉ	ⲗⲁⲁⲩ	1
ⲧⲉⲩ ϩⲉⲗⲡⲓⲥ	ϩⲉⲗⲡⲓⲥ	1
ⲟⲩ ⲥⲟⲟⲩⲛ	ⲥⲟⲟⲩⲛ	1
ⲟⲩ ⲥⲟⲫⲟⲥ	ⲥⲟⲫⲟⲥ	1
ⲧ ⲥⲟⲫⲓⲁ ⲙ ⲡ ⲕⲟⲥⲙⲟⲥ	ⲥⲟⲫⲓⲁ	1
ϩⲉⲛ ϩⲓⲟⲙⲉ ⲉⲃⲟⲗ ϩⲙ ⲡ ⲕⲁϩ ⲙ ⲙⲱⲁⲃ ⲉ ⲡ ⲣⲁⲛ ⲛ ⲧ ⲟⲩⲓ ⲙⲙⲟ ⲟⲩ ⲡⲉ ⲟⲣⲫⲁ ⲁⲩⲱ ⲡ ⲣⲁⲛ ⲛ ⲧ ⲙⲉϩⲥⲛⲧⲉ ⲧⲉ ϩⲣⲟⲩⲑ	ϩⲓⲟⲙⲉ	1
ⲡⲓ ⲕⲁⲓⲣⲟⲥ ⲟⲛ ⲡⲁⲓ	ⲕⲁⲓⲣⲟⲥ	1
ⲗⲁ	ⲗⲁ	1
ⲙⲉ	ⲙⲉ	1
ⲛⲏ	ⲛⲏ	1
ⲣⲟ	ⲣⲟ	1
ⲟⲩϫⲁⲓ ⲭⲱⲣⲓⲥ ⲡⲉ ⲑⲃⲃⲓⲟ ⲛ ϩⲏⲧ	ⲟⲩϫⲁⲓ	1
ⲡ ϣⲁϫⲉ ⲙ ⲡ ϫⲟⲉⲓⲥ ⲉⲛⲧ ⲁ ⲕ ϫⲓⲟⲩⲁ ⲉⲣⲟ ϥ	ϣⲁϫⲉ	1
ⲛⲁ ⲉⲓⲟⲟⲧⲉ	ⲉⲓⲟⲟⲧⲉ	1
ⲡⲉⲓ ⲣⲟⲟⲩⲧ ⲉϩⲟⲩⲛ ⲉ ⲛⲁ ⲡⲉ ⲭⲣⲓⲥⲧⲟⲥ	ⲣⲟⲟⲩⲧ	1
ⲧⲁ ⲕⲗⲏⲣⲟⲛⲟⲙⲓⲁ	ⲕⲗⲏⲣⲟⲛⲟⲙⲓⲁ	1
ⲡⲣⲟⲫⲏⲧⲏⲥ	ⲡⲣⲟⲫⲏⲧⲏⲥ	1
ⲛ ⲉⲧ ϥ ϯ ⲙⲙⲟ ⲟⲩ ⲛ ⲛⲉϥ ϩⲙϩⲁⲗ ⲙ ⲙⲏⲏⲛⲉ	ⲛ	1
ⲁⲅⲁⲡⲏ	ⲁⲅⲁⲡⲏ	1
ⲍⲁⲭⲁⲓⲟⲥ ⲡ ⲧⲉⲗⲱⲛⲏⲥ ⲡⲁⲓ ⲉⲛⲧ ⲁ ϥ ⲧⲟϣ ϥ ⲉ ϯ ⲙ ⲡ ⲉⲛⲧ ⲁ ϥ ϩⲟⲩⲗⲁ ⲉⲣⲟ ϥ ⲛ ϥⲧⲟⲩ ⲕⲱⲃ	ⲍⲁⲭⲁⲓⲟⲥ	1
ⲩ ⲑⲃⲃⲓⲟ	ⲑⲃⲃⲓⲟ	1
ϣϫⲉ	ϣϫⲉ	1
ⲛⲁ ⲇⲓⲱⲅⲙⲟⲥ	ⲇⲓⲱⲅⲙⲟⲥ	1
ϩⲙϩⲁⲗ ⲛ ⲓⲁⲕⲱⲃ	ϩⲙϩⲁⲗ	1
ⲡ ⲙⲁ ⲉⲧⲉ ⲣ ⲁ ⲃⲱⲕ ⲣⲟ ϥ	ⲙⲁ	1
ϩⲉⲛ ϣⲃⲣⲣϩⲱⲃ ⲅⲁⲣ ⲛⲧⲉ ⲡ ⲛⲟⲩⲧⲉ	ϣⲃⲣⲣϩⲱⲃ	1
ⲩ ϣⲁϫⲉ	ϣⲁϫⲉ	1
ⲧ ⲁⲅⲁⲡⲏ ⲁϫⲛ ϩⲩⲡⲟⲕⲣⲓⲛⲉ	ⲁⲅⲁⲡⲏ	1
ⲧⲉⲕ ⲕⲁⲕⲓⲁ	ⲕⲁⲕⲓⲁ	1
ⲛⲉ ϩⲃⲏⲩⲉ ⲛ ⲧ ⲉⲝⲟⲩⲥⲓⲁ	ϩⲃⲏⲩⲉ	1
ϣⲏⲧ ⲛ ⲧⲃⲁ ⲙ ⲡⲁⲅⲁⲛⲱⲥ	ⲡⲁⲅⲁⲛⲱⲥ	1
ϣⲙⲧ	ϣⲙⲧ	1
ϣⲛⲁ	ϣⲛⲁ	1
ϣⲱⲥ	ϣⲱⲥ	1
ϩⲟⲓ	ϩⲟⲓ	1
ϫⲟⲓ	ϫⲟⲓ	1
ϭⲟⲗ	ϭⲟⲗ	1
ϯⲙⲉ	ϯⲙⲉ	1
ϯⲟⲩ	ϯⲟⲩ	1
ⲧⲉϥ ϩⲁⲏ	ϩⲁⲏ	1
ⲧⲉϥ ϭⲟⲙ	ϭⲟⲙ	1
ⲧⲉϥ ϯⲡⲉ	ϯⲡⲉ	1
ⲡ ⲣⲱⲙⲉ ⲙ ⲡⲟⲛⲏⲣⲟⲥ	ⲣⲱⲙⲉ	1
ⲧ ⲙⲛⲧⲣⲣⲟ ⲛ ⲇⲓⲟⲕⲗⲏϯⲁⲛⲟⲥ ⲡ ⲣⲣⲟ	ⲙⲛⲧⲣⲣⲟ	1
ⲡⲉⲛ ⲡⲉⲧⲟⲩⲁⲁⲃ ⲛ ⲉⲓⲱⲧ ⲉⲧ ⲧⲁⲓⲏⲩ ⲕⲁⲧⲁ ⲥⲙⲟⲧ ⲛⲓⲙ ⲡ ϩⲁⲅⲓⲟⲥ ⲁⲡⲁ ⲕⲩⲣⲟⲥ · ⲡ ⲧⲉⲗⲓⲟⲥ ⲛⲁⲙⲉ ⲛⲧ ⲁ ϥ ϩⲓⲥⲧⲟⲣⲓⲍⲉ ⲙⲙⲟ ϥ · ⲛϭⲓ ⲁⲡⲁ ⲡⲁⲙⲃⲱ ⲡⲉ ⲡⲣⲉⲥⲃⲩⲧⲉⲣⲟⲥ ⲛ ⲧ ⲉⲕⲕⲗⲏⲥⲓⲁ ⲛ ϣⲓⲏⲧ ⲛⲧ ⲁ ϥ ⲙⲧⲟⲛ ⲙⲙⲟ ϥ ⲛϭⲓ ⲡ ⲉⲧ ⲟⲩⲁⲁⲃ · ⲁⲡⲁ ⲕⲩⲣⲟⲥ ϩⲛ ⲥⲟⲩϣⲙⲟⲩⲛ ⲙ ⲡ ⲉⲃⲟⲧ ⲉⲡⲏⲡ ϩⲛ ⲟⲩ ⲉⲓⲣⲏⲛⲏ ⲛⲧⲉ ⲡ ⲛⲟⲩⲧⲉ	ⲕⲩⲣⲟⲥ	1
ⲡ ⲙⲩⲥⲧⲏⲣⲓⲟⲛ ⲛ ⲧ ⲙⲛⲧⲣⲣⲟ ⲙ ⲡ ⲛⲟⲩⲧⲉ	ⲙⲩⲥⲧⲏⲣⲓⲟⲛ	1
ⲛ ⲉⲡⲓⲥⲧⲟⲗⲏ ⲛⲉ ⲉⲛⲧ ⲁ ⲕ ⲡⲁϩ ⲟⲩ	ⲉⲡⲓⲥⲧⲟⲗⲏ	1
ⲙⲁⲛⲓⲁⲕⲏⲥ ⲛ ⲛⲟⲩⲃ	ⲙⲁⲛⲓⲁⲕⲏⲥ	1
ⲧ ⲙⲛⲧⲡⲁⲣⲑⲉⲛⲟⲥ	ⲙⲛⲧⲡⲁⲣⲑⲉⲛⲟⲥ	1
ⲡ ⲧⲟⲟⲩ ⲉⲧ ⲕ ⲛϩⲏⲧ ϥ ϩⲁⲣⲉϩ ⲉ ⲡⲉⲓ ϩⲱⲃ	ϩⲁⲣⲉϩ	1
ⲟⲩ ϣⲏⲛ ⲛ ⲁⲧⲕⲁⲣⲡⲟⲥ	ϣⲏⲛ	1
ⲧⲉ ⲭⲁⲣⲓⲥ ⲙ ⲡ ⲛⲟⲩⲧⲉ ⲧⲁⲓ ⲉⲛⲧ ⲁ ⲩ ⲧⲁⲁ ⲥ ⲛⲏ ⲧⲛ ϩⲙ ⲡⲉ ⲭⲣⲓⲥⲧⲟⲥ ⲓⲏⲥⲟⲩⲥ	ⲭⲁⲣⲓⲥ	1
ⲩ ϩⲏⲕⲉ	ϩⲏⲕⲉ	1
ⲡ ⲧⲁϣⲉⲟⲉⲓϣ	ⲧⲁϣⲉⲟⲉⲓϣ	1
ⲛⲉⲛ ⲉⲓⲟⲧⲉ ⲛ ⲁⲡⲟⲥⲧⲟⲗⲟⲥ	ⲉⲓⲟⲧⲉ	1
ⲡ ⲗⲁⲟⲥ ⲧⲏⲣ ϥ ⲛ ⲉⲧ ϩⲛ ⲧ ⲡⲩⲗⲏ	ⲗⲁⲟⲥ	1
ⲡ ⲉⲛⲧ ⲁ ⲕ ϫⲟⲟ ϥ ⲉⲣⲟ ⲓ	ⲡ	1
ⲡ ⲉⲧⲉ ⲛ ϥ ⲛⲏⲩ ⲁⲛ	ⲡ	1
ϩⲣⲟⲩⲑ ⲧ ⲙⲱⲁⲃⲓⲧⲏⲥ ⲧⲉⲥ ϣⲉⲗⲉⲉⲧ	ϩⲣⲟⲩⲑ	1
ⲧ ⲁⲛⲁⲡⲁⲩⲥⲓⲥ ⲙ ⲡ ϩⲁⲅⲓⲟⲥ · ⲓⲱϩⲁⲛⲛⲏⲥ · ⲡ ⲉⲩⲁⲅⲅⲉⲗⲓⲥⲧⲏⲥ · ⲁⲩⲱ ⲡ ⲁⲡⲟⲥⲧⲟⲗⲟⲥ ⲙ ⲡⲉ ⲭⲣⲓⲥⲧⲟⲥ · ϩⲛ ⲟⲩ ⲉⲓⲣⲏⲛⲏ · ⲛⲧⲉ ⲡ ⲛⲟⲩⲧⲉ	ⲁⲛⲁⲡⲁⲩⲥⲓⲥ	1
ⲛⲉⲕ ⲙⲁϩⲧ	ⲙⲁϩⲧ	1
ⲟⲩ ⲙⲉⲣⲓⲧ ⲛⲧⲁ ϥ	ⲙⲉⲣⲓⲧ	1
ⲛ ⲉⲧ ϫⲟⲥⲉ ⲛ ϩⲏⲧ	ⲛ	1
ⲛⲉⲓ ⲛⲟϭ ⲛ ϣⲁ	ϣⲁ	1
ⲟⲩ ⲟⲩⲱⲛϩ ⲉⲃⲟⲗ	ⲟⲩⲱⲛϩ	1
ⲁⲃⲃⲁⲕⲟⲩⲙ ⲡⲉ ⲡⲣⲟⲫⲏⲧⲏⲥ	ⲁⲃⲃⲁⲕⲟⲩⲙ	1
ⲡ ⲙⲁⲕⲁⲣⲓⲟⲥ ⲛ ⲁⲡⲟⲥⲧⲟⲗⲟⲥ · ⲁⲩⲱ ⲛ ⲉⲩⲁⲅⲅⲉⲗⲓⲥⲧⲏⲥ · ⲁⲩⲱ ⲡ ⲑⲉⲟⲗⲟⲅⲟⲥ · ⲁⲩⲱ ⲡ ⲡⲁⲣⲑⲉⲛⲟⲥ ⲉⲧ ⲟⲩⲁⲁⲃ · ⲡ ϩⲁⲅⲓⲟⲥ ⲓⲱϩⲁⲛⲛⲏⲥ · ⲡ ⲙⲉⲣⲓⲧ ⲙ ⲡⲉ ⲭⲣⲓⲥⲧⲟⲥ ⲓⲏⲥⲟⲩⲥ ⲡⲉⲛ ϫⲟⲉⲓⲥ · ⲁⲩⲱ ⲡⲉⲛ ⲛⲟⲩⲧⲉ · ⲁⲩⲱ ⲡⲉⲛ ⲥⲱⲧⲏⲣ	ⲓⲱϩⲁⲛⲛⲏⲥ	1
ⲟⲩ ⲕⲁⲧⲁⲅⲁⲓⲟⲛ	ⲕⲁⲧⲁⲅⲁⲓⲟⲛ	1
ⲟⲩ ⲧⲱⲟⲩⲛ	ⲧⲱⲟⲩⲛ	1
ⲃⲁⲗⲗⲁ	ⲃⲁⲗⲗⲁ	1
ⲛ ⲉⲧ ⲣϩⲟⲧⲉ ϩⲏⲧ ϥ ⲙ ⲡ ⲛⲟⲩⲧⲉ . ⲛⲁⲓ ⲉⲧⲉⲣⲉ ⲡⲉ ⲭⲣⲓⲥⲧⲟⲥ ϣⲟⲟⲡ ⲛⲁ ⲩ ⲛ ⲃⲟⲏⲑⲟⲥ ⲁⲩⲱ ⲛ ⲥⲕⲉⲡⲁⲥⲧⲏⲥ	ⲛ	1
ⲡ ⲕⲱ ⲉⲃⲟⲗ ⲛ ⲛ ⲛⲟⲃⲉ	ⲕⲱ	1
ⲡ ϣⲟⲩϩⲏⲛⲉ ⲉⲧⲉⲣⲉ ⲛ ⲣⲱⲙⲉ ⲧⲁⲗⲟ ⲙⲙⲟ ϥ ⲉϩⲣⲁⲓ	ϣⲟⲩϩⲏⲛⲉ	1
ⲡ ϩⲟϫϩϫ ⲛ ⲙ ⲙⲏⲏϣⲉ	ϩⲟϫϩϫ	1
ⲡ ⲉⲧ ⲛⲁ ϫⲓⲟⲩⲁ	ⲡ	1
ⲛⲉⲕ ⲟⲩⲱϣ	ⲟⲩⲱϣ	1
ⲃⲉⲉⲕⲉ	ⲃⲉⲉⲕⲉ	1
ⲛⲉⲕ ⲣⲱⲙⲉ	ⲣⲱⲙⲉ	1
ⲛ ⲣⲉϥⲥⲁϩⲟⲩ	ⲣⲉϥⲥⲁϩⲟⲩ	1
ⲡ ⲙⲁⲣⲧⲩⲣⲓⲟⲛ ⲉⲧ ϩⲙ ⲡ ⲓⲥⲣⲁⲏⲗ	ⲙⲁⲣⲧⲩⲣⲓⲟⲛ	1
ⲛⲉⲕ ⲥⲙⲟⲩ	ⲥⲙⲟⲩ	1
ⲛⲉⲕ ⲥⲛⲏⲩ	ⲥⲛⲏⲩ	1
ⲡⲉ ϩⲙⲉ ⲛ ϣⲉ ⲛ ⲣⲱⲙⲉ	ⲣⲱⲙⲉ	1
ⲛⲉⲛ ⲙⲉⲉⲩⲉ	ⲙⲉⲉⲩⲉ	1
ⲧⲉ ϣⲧⲏⲛ ⲙ ⲡⲗϭⲉ	ϣⲧⲏⲛ	1
ⲩ ⲗⲁⲁⲩ ϩⲛ ⲧ ⲡⲟⲣϣⲥ	ⲗⲁⲁⲩ	1
ⲡ ⲉⲧ ⲧⲱϭⲉ ⲇⲉ ⲙⲙⲟ ϥ ⲉ ⲡ ϫⲟⲉⲓⲥ	ⲡ	1
ⲧ ⲇⲓⲁⲕⲟⲛⲓⲁ	ⲇⲓⲁⲕⲟⲛⲓⲁ	1
ⲛⲉ ⲡⲣⲉⲥⲃⲩⲧⲉⲣⲟⲥ ⲙ ⲡ ⲗⲁⲟⲥ	ⲡⲣⲉⲥⲃⲩⲧⲉⲣⲟⲥ	1
ⲡ ⲙⲁ ⲉⲧ ⲥ ⲛϩⲏⲧ ϥ	ⲙⲁ	1
ⲧ ⲃⲁϣⲟⲣ	ⲃⲁϣⲟⲣ	1
ϩⲱⲧ ⲛ ⲁⲥ	ϩⲱⲧ	1
ⲙⲛⲧⲣⲉϥⲣⲡⲉⲧⲛⲁⲛⲟⲩϥ	ⲙⲛⲧⲣⲉϥⲣⲡⲉⲧⲛⲁⲛⲟⲩϥ	1
ϩⲉⲛ ϩⲟⲙⲛⲧ	ϩⲟⲙⲛⲧ	1
ⲛⲉϥ ϩⲓⲟⲟⲩⲉ ⲧⲏⲣ ⲟⲩ ⲉⲧ ⲛⲁⲛⲱ ⲟⲩ	ϩⲓⲟⲟⲩⲉ	1
ⲡ ⲙⲁ ⲛⲧ ⲁ ϥ ⲡⲁϩ ϥ	ⲙⲁ	1
ϩⲉⲛ ⲡⲣⲟⲥⲟⲩⲟⲉⲓϣ	ⲡⲣⲟⲥⲟⲩⲟⲉⲓϣ	1
ⲡ ⲉⲧ ⲛⲁ ϣ ⲧⲁⲩⲉ ⲛⲉⲧⲛ ⲡⲉⲧϩⲟⲟⲩ ⲧⲏⲣ ⲟⲩ	ⲡ	1
ⲛ ⲉⲛⲧ ⲁ ϥ ⲥⲟⲧⲙ ⲟⲩ	ⲛ	1
ⲡ ϩⲁⲅⲓⲟⲥ ⲃⲓⲕⲧⲱⲣ ⲡⲉ ⲥⲧⲣⲁⲧⲏⲗⲁⲧⲏⲥ ⲁⲩⲱ ⲡ ⲙⲁⲣⲧⲩⲣⲟⲥ ⲉⲧ ⲧⲁⲓⲏⲩ ⲙ ⲡⲉ ⲭⲣⲓⲥⲧⲟⲥ · ⲁⲩⲱ ⲡ ϥⲁⲓⲕⲗⲟⲙ ⲛⲁⲙⲉ · ⲛⲧ ⲁ ϥ ϫⲱⲕ ϫⲉ ⲉⲃⲟⲗ ⲙ ⲡⲉϥ ⲁⲅⲱⲛ ⲉⲧ ⲧⲁⲓⲏⲩ · ⲛ ⲥⲟⲩ ϫⲟⲩⲧⲥⲁϣϥⲉ ⲙ ⲡ ⲉⲃⲟⲧ ⲫⲁⲣⲙⲟⲩⲧⲉ	ⲃⲓⲕⲧⲱⲣ	1
ⲡ ⲛⲁⲏⲧ ⲙⲁⲩⲁⲁ ϥ · ⲁⲩⲱ ⲡ ⲙⲁⲓ ⲣⲱⲙⲉ ⲛⲓⲙ	ⲛⲁⲏⲧ	1
ⲣⲉϥⲥⲁϩⲟⲩ	ⲣⲉϥⲥⲁϩⲟⲩ	1
ⲡ ⲙⲁ ⲉⲧ ϥ ⲛⲁ ⲃⲱⲕ ⲉϩⲟⲩⲛ ⲉⲣⲟ ϥ	ⲙⲁ	1
ⲧⲟⲩ ⲗⲁⲕⲙ	ⲗⲁⲕⲙ	1
ϯ ⲛⲟϭ ⲛ ϣⲡⲏⲣⲉ ⲛⲧ ⲁ ⲥ ⲧⲁϩⲟ ⲓ	ϣⲡⲏⲣⲉ	1
ⲟⲩ ⲧⲟⲡⲟⲥ ⲉⲣⲉ ⲟⲩ ⲥⲟⲛ ϣⲱⲛⲉ ⲛϩⲏⲧ ϥ	ⲧⲟⲡⲟⲥ	1
ⲛ ⲉⲧⲉⲣⲉ ⲛ ⲉⲡⲁⲣⲭⲟⲥ ⲛⲁ ⲧⲁⲁ ⲩ ⲙⲛ ⲛⲉ ⲥⲧⲣⲁⲧⲏⲗⲁⲧⲏⲥ	ⲛ	1
ⲧ ⲓⲇⲟⲩⲙⲁⲓⲁ	ⲓⲇⲟⲩⲙⲁⲓⲁ	1
ⲟⲩ ⲡⲁϣⲉ ⲛ ϩⲟⲟⲩ	ⲡⲁϣⲉ	1
ⲙⲁⲁⲩ ⲛⲓⲙ	ⲙⲁⲁⲩ	1
ⲧ ⲡⲩⲗⲏ ⲛ ⲧ ⲡⲟⲗⲓⲥ	ⲡⲩⲗⲏ	1
ⲟⲩ ⲥⲟⲩⲟ ⲉ ϥ ⲙⲉϩ ϩⲙ ⲡ ϩⲙⲥ	ⲥⲟⲩⲟ	1
ⲡ ⲟⲩⲟⲉⲓⲛ ϣⲟⲟⲡ ⲛⲙⲙⲁ ⲛ ⲉⲧⲉ ⲛⲉ ⲥⲃⲟⲟⲩⲉ ⲛⲉ ⲛ ⲛⲉⲛ ⲉⲓⲟⲧⲉ	ϣⲟⲟⲡ	1
ⲙ ⲡⲛⲏ ⲙ ⲡⲉⲕ ⲏⲓ	ⲡⲛⲏ	1
ϩⲙⲉ ⲛ ϩⲟⲟⲩ	ϩⲟⲟⲩ	1
ϩⲉⲛ ⲙⲛⲧⲙⲁⲓⲧⲟ ⲛ ϩⲟⲩⲟ	ⲙⲛⲧⲙⲁⲓⲧⲟ	1
ⲡⲁϩⲟⲩ ⲙ ⲡ ⲥⲉⲉⲡⲉ	ⲡⲁϩⲟⲩ	1
ⲧ ⲁⲅⲁⲡⲏ ⲙ ⲡⲉ ⲡⲛⲉⲩⲙⲁ	ⲁⲅⲁⲡⲏ	1
ⲡ ϣⲁϩ ⲛ ϩⲉⲛ ϩⲏⲃⲥ	ϣⲁϩ	1
ⲅⲁⲓⲟⲥ	ⲅⲁⲓⲟⲥ	1
ⲟⲩ ⲉⲓⲣⲏⲛⲏ · ⲛⲧⲉ ⲡ ⲛⲟⲩⲧⲉ	ⲉⲓⲣⲏⲛⲏ	1
ⲟⲩ ⲣⲱⲙⲉ ⲉ ϥ ⲥⲏϭ ⲉⲣⲉ ϥⲧⲟⲟⲩ ⲛ ⲣⲱⲙⲉ ϥⲓ ϩⲁⲣⲟ	ⲣⲱⲙⲉ	1
ⲡⲉⲥ ⲡⲩⲗⲁⲓⲟⲛ · ⲛⲧ ⲁ ⲓ ⲛⲁⲩ ⲉⲣⲟ ϥ ⲛ ϣⲟⲣⲡ	ⲡⲩⲗⲁⲓⲟⲛ	1
ⲛⲉⲩ ϩⲓⲟⲙⲉ	ϩⲓⲟⲙⲉ	1
ⲗⲁⲁⲩ ⲛ ⲧⲣⲟⲫⲏ ⲉ ⲡⲁ ⲡⲉⲓ ⲕⲟⲥⲙⲟⲥ ⲡⲉ	ⲗⲁⲁⲩ	1
ⲛⲉⲩ ⲕⲗⲏⲣⲟⲥ	ⲕⲗⲏⲣⲟⲥ	1
ⲩ ϣⲓⲡⲉ ⲛⲏ ⲧⲛ	ϣⲓⲡⲉ	1
ⲡ ⲗⲟⲅⲟⲥ · ⲡⲉ ϩⲙⲟⲩ · ⲡ ⲱⲛⲉ ⲙ ⲙⲉ · ⲡ ⲁϩⲟ ⲉⲧ ⲟⲩⲁⲁⲃ · ⲡ ϩⲃⲃⲉ · ⲧ ⲁⲃⲱ · ⲧ ⲙⲛⲧⲛⲟϭ · ⲡ ⲉⲛⲧ ⲁ ⲩ ϫⲟⲟ ⲥ ⲉⲣⲟ ϥ · ϫⲉ ϣⲏⲣⲉ ⲛ ⲣⲱⲙⲉ ⲉⲧⲃⲏⲏⲧ ⲛ · ϫⲉⲕⲁⲥ ⲉϥⲉ ⲧⲟⲩϫⲟ ⲙ ⲡ ⲅⲉⲛⲟⲥ ⲛ ⲛ ⲣⲱⲙⲉ	ⲗⲟⲅⲟⲥ	1
ⲛ ⲧⲁⲉⲓⲟ ⲛⲧ ⲁ ϥ ⲧⲁⲁ ⲩ ⲛⲁ ⲩ	ⲧⲁⲉⲓⲟ	1
ⲧ ⲡⲏⲅⲏ ⲙ ⲡⲉⲥ ⲥⲛⲟϥ	ⲡⲏⲅⲏ	1
ϩⲉⲛ ϫⲓⲟⲩⲉ	ϫⲓⲟⲩⲉ	1
ⲡ ⲙⲁⲕⲁⲣⲓⲟⲥ ⲇⲉ ⲁⲡⲁ ⲃⲓⲕⲧⲱⲣ	ⲃⲓⲕⲧⲱⲣ	1
ⲩ ⲟⲩϫⲁⲓ	ⲟⲩϫⲁⲓ	1
ⲡ ⲏⲓ ⲙ ⲡⲉⲥ ϩⲁⲓ	ⲏⲓ	1
ⲡⲁ ⲡⲁⲩⲗⲟⲥ	ⲡⲁ	1
ⲛⲉⲧⲛ ϩⲏⲧ	ϩⲏⲧ	1
ⲛ ⲉⲛⲧ ⲁ ⲛ ⲁⲁ ⲩ ϩⲛ ⲧⲉⲛ ϭⲓⲛⲱⲛⲁϩ	ⲛ	1
ⲧⲉϥ ⲡⲁⲛⲟⲩⲣⲅⲓⲁ	ⲡⲁⲛⲟⲩⲣⲅⲓⲁ	1
ⲟⲩ ⲉⲓⲁ ⲛ ⲧⲟⲟⲩ	ⲉⲓⲁ	1
ⲡ ⲉⲧ ⲛⲁ ⲙⲉⲣⲉ ⲡ ⲡⲉⲧϩⲟⲟⲩ	ⲡ	1
ⲧⲉⲕ ⲙⲛⲧⲛⲁ	ⲙⲛⲧⲛⲁ	1
ⲧ ϣⲏⲩⲉ ⲉⲧ ⲙⲟⲩϩ	ϣⲏⲩⲉ	1
ⲛⲟⲉⲙⲓⲛ ⲧ ⲉⲛⲧ ⲁ ⲥ ⲕⲧⲟ ⲥ ⲉⲃⲟⲗ ϩⲛ ⲧ ⲥⲱϣⲉ ⲙ ⲙⲱⲁⲃ	ⲛⲟⲉⲙⲓⲛ	1
ⲕⲁⲣⲡⲟⲥ ⲛ ⲛ ϣⲏⲛ	ⲕⲁⲣⲡⲟⲥ	1
ⲛ ϩⲁⲗⲁⲧⲉ	ϩⲁⲗⲁⲧⲉ	1
ⲡ ϩⲟ ⲛ ⲏⲥⲁⲩ · ⲡⲉϥ ⲥⲟⲛ	ϩⲟ	1
ϣⲧⲏⲛ ⲥⲛⲧⲉ	ϣⲧⲏⲛ	1
ⲛ ϭⲱⲃ ⲛⲧⲉ ⲡ ⲕⲟⲥⲙⲟⲥ	ϭⲱⲃ	1
ⲡ ⲣⲡⲉ ⲅⲁⲣ ⲙ ⲡ ⲛⲟⲩⲧⲉ	ⲣⲡⲉ	1
ϥⲧⲟⲟⲩ ⲇⲉ ⲛ ϩⲟⲟⲩ	ϥⲧⲟⲟⲩ	1
ⲛ ⲉⲛⲧ ⲁ ϥ ⲁⲁ ⲩ ϩⲛ ⲟⲩ ⲙⲛⲧⲁⲙⲉⲗⲏⲥ ⲛ ϣⲟⲣⲡ	ⲛ	1
ⲡⲉϥ ϣⲓ	ϣⲓ	1
ⲡⲉϥ ϥⲱ	ϥⲱ	1
ⲇⲓⲁⲕⲟⲛⲟⲥ	ⲇⲓⲁⲕⲟⲛⲟⲥ	1
ⲛ ϩⲙϩⲁⲗ ⲁⲛ ⲛ ⲣⲱⲙⲉ	ϩⲙϩⲁⲗ	1
ⲟⲩ ⲉⲝⲉⲇⲣⲁ	ⲉⲝⲉⲇⲣⲁ	1
ⲥϣ ⲛ ⲧⲁϭⲥⲉ ⲛ ⲟⲩⲱⲧ · ⲛⲧⲉ ⲛⲉϥ ⲟⲩⲣⲏⲏⲧⲉ	ⲥϣ	1
ⲛⲉ ϫⲡⲟ ⲙ ⲫⲁⲣⲉⲥ	ϫⲡⲟ	1
ⲟⲩ ⲛⲟϭ ⲟⲛ ⲙ ⲙⲏⲏϣⲉ	ⲙⲏⲏϣⲉ	1
ⲡ ⲉⲧ ⲓ ⲛⲁ ϩⲉ ⲉⲣⲟ ϥ ⲉ ϥ ⲥⲱⲧⲡ · ⲉ ϥ ⲧⲃⲃⲏⲩ ⲉ ϩⲟⲩⲟ ⲉⲣⲟ ⲕ	ⲡ	1
ⲡⲉ ⲥⲙⲟⲩ ⲙ ⲡ ⲥⲟⲛ ⲉⲧ ⲙⲙⲁⲩ	ⲥⲙⲟⲩ	1
ⲡⲉϥ ⲃⲱ	ⲃⲱ	1
ⲡⲉϥ ⲛⲁ	ⲛⲁ	1
ⲑⲁⲇⲇⲁⲓⲟⲥ	ⲑⲁⲇⲇⲁⲓⲟⲥ	1
ⲡ ⲉⲩⲁⲅⲅⲉⲗⲓⲟⲛ ⲛ ⲓⲏⲥⲟⲩⲥ ⲡⲉ ⲭⲣⲓⲥⲧⲟⲥ [ ⲡ ϣⲏⲣⲉ ⲙ ⲡ ⲛⲟⲩⲧⲉ ]	ⲉⲩⲁⲅⲅⲉⲗⲓⲟⲛ	1
ⲃⲁⲥⲓⲙⲟⲥ ⲡ ⲉⲧ ϣⲟⲟⲡ ϩⲛ ⲛ ⲉⲧ ⲟⲩⲁⲁⲃ	ⲃⲁⲥⲓⲙⲟⲥ	1
ⲡⲉϥ ⲡⲛⲉⲩⲙⲁ ⲉⲧ ⲟⲩⲁⲁⲃ	ⲡⲛⲉⲩⲙⲁ	1
ⲡ ⲟⲩⲟⲧⲟⲩⲉⲧ ⲛ ⲧ ⲥⲱϣⲉ	ⲟⲩⲟⲧⲟⲩⲉⲧ	1
ⲛⲉϥ ⲁⲅⲅⲉⲗⲟⲥ ⲧⲏⲣ ⲟⲩ	ⲁⲅⲅⲉⲗⲟⲥ	1
ⲕⲱ ⲉⲃⲟⲗ	ⲕⲱ	1
ⲛⲉ ϩⲃⲏⲩⲉ ⲛ ⲛⲓ ⲣⲱⲙⲉ ⲉⲧ ⲙⲉⲉⲩⲉ ⲉ ϩⲉⲛ ⲡⲟⲛⲏⲣⲟⲛ ⲛ ⲛⲁⲩ ⲛⲓⲙ ⲉϩⲟⲩⲛ ⲉⲣⲟ ⲟⲩ	ϩⲃⲏⲩⲉ	1
ⲡ ⲛⲟⲩⲧⲉ ⲉⲧ ϫⲟⲥⲉ	ⲛⲟⲩⲧⲉ	1
ⲡ ϣⲁϫⲉ ⲅⲁⲣ ⲙ ⲡⲉ ⲥⲧⲁⲩⲣⲟⲥ	ϣⲁϫⲉ	1
ⲧⲉⲕ ⲛⲟⲩⲛⲉ	ⲛⲟⲩⲛⲉ	1
ⲟⲩ ⲭⲣⲏⲙⲁ	ⲭⲣⲏⲙⲁ	1
ϩⲉⲛ ϭⲱⲱⲃⲉ	ϭⲱⲱⲃⲉ	1
ⲡⲉ ⲑⲩⲥⲓⲁⲥⲧⲏⲣⲓⲟⲛ	ⲑⲩⲥⲓⲁⲥⲧⲏⲣⲓⲟⲛ	1
ⲛ ⲅⲉⲣⲁⲥⲏⲛⲟⲥ	ⲅⲉⲣⲁⲥⲏⲛⲟⲥ	1
ⲡⲉϥ ⲭⲣⲓⲥⲧⲟⲥ	ⲭⲣⲓⲥⲧⲟⲥ	1
ⲡ ϩⲙϩⲁⲗ ⲙ ⲡ ⲙⲁⲙⲙⲱⲛⲁⲥ	ϩⲙϩⲁⲗ	1
ϩⲉⲛ ⲙⲁ ⲛ ⲕⲁⲕⲉ ⲉ ⲩ ϣⲟⲕϩ ⲉⲙⲁⲧⲉ	ⲙⲁ	1
ⲡ ⲛⲁⲩ ⲉⲧ ⲙⲙⲁⲩ	ⲛⲁⲩ	1
ⲛⲉ ϩⲛⲁⲁⲩ ⲛ ⲛ ϩⲏⲕⲉ	ϩⲛⲁⲁⲩ	1
ⲟⲩⲉⲓ ⲛⲁ ⲕ	ⲟⲩⲉⲓ	1
ⲡ ⲙⲧⲟⲛ ⲉⲧ ⲛ ϩⲉⲗⲡⲓⲍⲉ ⲉⲣⲟ ϥ	ⲙⲧⲟⲛ	1
ⲛ ⲉⲕⲕⲗⲏⲥⲓⲁ ⲧⲏⲣ ⲟⲩ	ⲉⲕⲕⲗⲏⲥⲓⲁ	1
ⲡⲉϥ ϫⲟⲉⲓⲥ	ϫⲟⲉⲓⲥ	1
ⲡ ⲡⲟⲛⲏⲣⲟⲥ ⲛ ⲣⲱⲙⲉ ⲉⲧ ⲏⲡ ⲉ ⲡ ⲣⲉϥⲣⲛⲟⲃⲉ ⲡ ⲥⲁⲧⲁⲛⲁⲥ	ⲡⲟⲛⲏⲣⲟⲥ	1
ⲛ ϩⲙϩⲁⲗ ⲙ ⲡ ⲛⲟⲩⲧⲉ · ⲉⲧ ϣⲟⲟⲡ ϩⲙ ⲡⲉⲓ ϫⲁⲓⲉ	ϩⲙϩⲁⲗ	1
ⲡⲉⲥ ⲕⲁⲣⲡⲟⲥ	ⲕⲁⲣⲡⲟⲥ	1
ⲧ ⲙⲛⲧⲁⲧϩⲛⲁⲁⲩ	ⲙⲛⲧⲁⲧϩⲛⲁⲁⲩ	1
ⲡ ϩⲱⲃ ⲛ ϭⲓϫ	ϩⲱⲃ	1
ϩⲣⲟⲩⲑ ⲧ ⲙⲱⲁⲃⲓⲧⲏⲥ ⲧ ϩⲓⲙⲉ ⲙ ⲙⲁⲁⲗⲱⲛ	ϩⲣⲟⲩⲑ	1
ⲡⲉ ⲥⲡⲏⲗⲁⲓⲟⲛ	ⲥⲡⲏⲗⲁⲓⲟⲛ	1
ⲩ ⲙⲏⲏϣⲉ	ⲙⲏⲏϣⲉ	1
ⲁⲣⲕⲁⲇⲓⲟⲥ	ⲁⲣⲕⲁⲇⲓⲟⲥ	1
ⲩ ⲙⲉⲉⲩⲉ	ⲙⲉⲉⲩⲉ	1
ⲧ ⲙⲛⲧϫⲱⲱⲣⲉ ⲛ ⲟⲩ ϣⲏⲣⲉ ϣⲏⲙ ϫⲉ ⲃⲓⲕⲧⲱⲣ	ⲙⲛⲧϫⲱⲱⲣⲉ	1
ⲛ ⲟⲩⲁϩⲓⲏⲧ ⲛ ⲁⲧⲛⲁϩⲧⲉ	ⲟⲩⲁϩⲓⲏⲧ	1
ⲛⲟϭ ⲅⲁⲣ ⲛ ⲟⲩⲟⲉⲓϣ	ⲟⲩⲟⲉⲓϣ	1
ⲡ ⲉⲧ ϥ ⲛⲁ ϭⲛⲧ ϥ	ⲡ	1
ⲃⲁⲥⲓⲗⲉⲓⲧⲏⲥ ⲡⲉ ⲥⲧⲣⲁⲧⲏⲗⲁⲧⲏⲥ	ⲃⲁⲥⲓⲗⲉⲓⲧⲏⲥ	1
ⲕⲁⲣⲡⲟⲥ ⲛ ⲧⲉⲓ ⲃⲱ ⲛ ⲕⲛⲧⲉ	ⲕⲁⲣⲡⲟⲥ	1
ϩⲱⲃ ⲛⲓⲙ ⲉⲛⲧ ⲁ ⲡ ⲣⲱⲙⲉ ⲁⲁ ⲩ ⲛⲙⲙⲁ ⲥ	ϩⲱⲃ	1
ⲡ ⲧⲣⲉ ⲡ ⲣⲱⲙⲉ ⲇⲉ ⲧⲱⲱⲃⲉ ⲛ ⲟⲩ ⲡⲉⲧϩⲟⲟⲩ ⲉ ⲡ ⲙⲁ ⲛ ⲟⲩ ⲡⲉⲧⲛⲁⲛⲟⲩϥ	ⲧⲣⲉ	1
ⲡ ⲣⲁⲛ ⲙ ⲡ ⲛⲟⲩⲧⲉ	ⲣⲁⲛ	1
ⲛⲉⲛ ϩⲟⲡⲗⲟⲛ	ϩⲟⲡⲗⲟⲛ	1
ⲡⲁ ⲡⲉⲓ ⲕⲟⲥⲙⲟⲥ	ⲡⲁ	1
ⲉⲣⲏⲧⲉ	ⲉⲣⲏⲧⲉ	1
ⲉⲣⲱⲧⲉ	ⲉⲣⲱⲧⲉ	1
ⲡⲉ ⲥⲙⲟⲩ ⲙ ⲡ ⲁⲅⲅⲉⲗⲟⲥ ⲉⲧ ⲙⲟⲟϣⲉ ⲛⲙⲙⲁ ϥ	ⲥⲙⲟⲩ	1
ϩⲉⲛ ⲥⲛⲏⲩ ⲕⲁⲧⲁ ⲡⲉⲛ ⲃⲓⲟⲥ , ⲉ ⲩ ⲛⲏⲥⲧⲉⲩⲉ ⲉ ⲩ ϣⲗⲏⲗ ⲇⲉ ⲟⲛ · ⲉ ⲩ ⲟ ⲛ ⲟⲩϣⲏ ⲛ ⲣⲟⲉⲓⲥ · ⲉ ⲩ ϫⲓϭⲟⲗ ⲇⲉ ⲟⲛ · ⲉ ⲩ ⲙⲓϣⲉ · ⲉ ⲩ ϯⲧⲱⲛ · ⲉ ⲩ ⲕⲣⲙⲣⲙ ⲁⲩⲱ ⲉ ⲩ ⲕⲁⲧⲁⲗⲁⲗⲉⲓ · ⲉ ⲩ ⲙⲟⲥⲧⲉ · ⲉ ⲩ ⲙⲟⲟϣⲉ ϩⲛ ⲟⲩ ϩⲏⲧ ⲙ ⲙⲛⲧϣⲙⲙⲟ · ⲉ ⲩ ϫⲱϩⲙ ⲙⲙⲟ ⲟⲩ · ⲁⲩⲱ ⲉ ⲩ ⲟ ⲛ ⲕⲣⲟϥ . ⲉ ⲩ ⲉⲓⲣⲉ ⲛ ϩⲱⲃ ⲛⲓⲙ ⲉ ϥ ϩⲟⲟⲩ	ⲥⲛⲏⲩ	1
ⲡⲁⲓ ⲛ ⲧⲉⲓ ⲙⲓⲛⲉ	ⲡⲁⲓ	1
ϩⲉⲛ ⲁⲧⲕⲓⲙ ⲉⲣⲟ ⲟⲩ	ⲁⲧⲕⲓⲙ	1
ϫⲟⲩⲱⲧⲉ ⲛ ⲣⲟⲙⲡⲉ	ⲣⲟⲙⲡⲉ	1
ⲡⲉ ϫⲡⲟ ⲛ ⲛⲉ ϩⲓⲟⲟⲙⲉ	ϫⲡⲟ	1
ⲟⲩ ⲃⲁⲡⲧⲓⲥⲙⲁ ⲙ ⲙⲉⲧⲁⲛⲟⲓⲁ ⲉ ⲡ ⲕⲱ ⲉⲃⲟⲗ ⲛ ⲛ ⲛⲟⲃⲉ	ⲃⲁⲡⲧⲓⲥⲙⲁ	1
ⲛ ⲕⲁⲧⲁ ⲛⲉ ⲅⲣⲁⲫⲏ	ⲅⲣⲁⲫⲏ	1
ⲙⲁⲁⲃⲉ ⲛ ⲣⲟⲙⲡⲉ	ⲣⲟⲙⲡⲉ	1
ⲡ ⲁⲅⲁⲑⲟⲥ ⲛ ⲣⲱⲙⲉ	ⲁⲅⲁⲑⲟⲥ	1
ⲡ ⲣⲱⲙⲉ ⲉⲧ ϩⲏⲩ ⲉϩⲣⲁⲓ ⲉ ϩⲉⲛ ⲛⲟϭ ⲙ ⲡ ⲉⲧ ϩⲟⲟⲩ	ⲣⲱⲙⲉ	1
ⲛⲁ ϩⲓⲟⲟⲩⲉ ⲉⲧ ϩⲙ ⲡⲉ ⲭⲣⲓⲥⲧⲟⲥ	ϩⲓⲟⲟⲩⲉ	1
ⲩ ⲛⲟϭ ⲉⲣⲟ ⲕ · ⲉⲣⲉ ⲡ ⲛⲟⲩⲧⲉ ⲛϩⲏⲧ ϥ	ⲕ	1
ⲡ ⲉⲧ ⲟⲩ ⲛⲁ ϭⲛⲧ ϥ	ⲡ	1
ⲧ ⲉϩⲉ ⲛⲧ ⲁ ⲓ ⲕⲟⲛⲥ ⲟⲩ ϩⲛ ⲛ ⲏⲓ ⲛ ⲛ ϩⲉⲗⲗⲏⲛ	ⲉϩⲉ	1
ⲡ ⲉⲛⲧ ⲁ ϥ ⲧⲁⲙⲓⲟ ⲟⲩ ⲉⲧⲉ ⲡ ⲛⲟⲩⲧⲉ	ⲡ	1
ⲛⲉ ϩⲣϣⲓⲣⲉ	ϩⲣϣⲓⲣⲉ	1
ⲟⲩⲁ ⲛ ⲛ ⲥⲩⲛⲕⲗⲏⲧⲓⲕⲟⲥ · ⲉ ⲁ ϥ ⲁⲡⲟⲧⲁⲥⲥⲉ ⲛ ⲛⲉϥ ⲭⲣⲏⲙⲁ ⲧⲏⲣ ⲟⲩ ⲁ ϥ ⲧⲁⲁ ⲩ ⲛ ⲛ ϩⲏⲕⲉ	ⲟⲩⲁ	1
ⲡⲉⲕ ⲥⲁ ⲛϩⲟⲩⲛ	ⲥⲁ	1
ⲛ ⲉⲃⲟⲗ ϩⲛ ⲟⲩ ϯⲧⲱⲛ ⲉⲧ ⲟ ⲛ ⲁⲧⲥⲱⲧⲙ ⲛⲥⲁ ⲧ ⲙⲉ	ϯⲧⲱⲛ	1
ϩⲉⲛ ⲡⲁⲓⲇⲉⲥ	ⲡⲁⲓⲇⲉⲥ	1
ⲡ ⲟⲩⲁ ⲡ ⲟⲩⲁ ⲙⲙⲱ ⲧⲛ	ⲟⲩⲁ	1
ⲡⲁⲅⲁⲛⲱⲥ	ⲡⲁⲅⲁⲛⲱⲥ	1
ⲡ ⲧⲣⲉ ⲡ ⲣⲱⲙⲉ ⲧⲱⲱⲃⲉ ⲛ ⲟⲩ ⲡⲉⲧⲛⲁⲛⲟⲩϥ ⲉ ⲡ ⲙⲁ ⲛ ⲟⲩ ⲡⲉⲧϩⲟⲟⲩ	ⲧⲣⲉ	1
ⲣⲱⲙⲉ ⲉ ⲟⲩⲛⲧ ϥ ⲓⲏⲥⲟⲩⲥ ⲙⲙⲁⲩ	ⲣⲱⲙⲉ	1
ⲡ ϩⲙϩⲁⲗ	ϩⲙϩⲁⲗ	1
ⲡ ⲧⲣⲉ ⲕ ⲧⲁⲁ ⲩ ⲉϩⲣⲁⲓ ⲉ ⲧⲟⲟⲧ ⲟⲩ	ⲧⲣⲉ	1
ⲡ ϣⲁϫⲉ ⲛ ⲥⲁⲟⲩⲗ	ϣⲁϫⲉ	1
ⲡ ⲙⲁ ⲉⲧ ⲉϣϣⲉ	ⲙⲁ	1
ⲙⲁ ⲛⲓⲙ ⲉⲧ ⲟⲩ ⲉⲡⲓⲕⲁⲗⲉⲓ ⲙⲙⲟ ϥ ⲛϩⲏⲧ ⲟⲩ	ⲙⲁ	1
ⲡⲉϥ ⲥⲙⲟⲧ ⲛ ϩⲟⲟⲩⲧ	ⲥⲙⲟⲧ	1
ⲡⲉⲕ ⲱϩⲥ	ⲱϩⲥ	1
ϩⲁϩ ⲛ ⲉⲓⲱⲧ	ⲉⲓⲱⲧ	1
ⲡ ϩⲁⲏ ⲛ ϩⲟⲟⲩ	ϩⲁⲏ	1
ⲡ ⲏⲓ ⲛ ⲧⲉⲥ ⲙⲁⲁⲩ	ⲏⲓ	1
ⲡ ⲉⲧ ϥⲓ ⲙ ⲡ ⲣⲟⲟⲩϣ ⲙ ⲡ ⲛⲁ	ⲡ	1
ⲡ ϣⲓⲡⲉ ⲙ ⲡⲉⲓ ⲙⲁ	ϣⲓⲡⲉ	1
ⲡⲉⲕ ⲃⲁⲗ	ⲃⲁⲗ	1
ⲡⲉⲕ ⲥⲁϩ	ⲥⲁϩ	1
ⲡⲉⲕ ⲥⲱϣ	ⲥⲱϣ	1
ⲡⲉⲕ ⲥⲟⲓ	ⲥⲟⲓ	1
ⲡⲉϥ ⲥⲛⲟϥ ⲉⲧ ⲟⲩⲁⲁⲃ	ⲥⲛⲟϥ	1
ⲡ ⲉⲧⲉ ⲩⲛⲧⲁ ϥ ⲥϥ	ⲡ	1
ⲡⲉ ⲡⲣⲉⲥⲃⲩⲧⲉⲣⲟⲥ ⲛ ϣⲓⲏⲧ	ⲡⲣⲉⲥⲃⲩⲧⲉⲣⲟⲥ	1
ⲟⲩ ⲙⲛⲧⲕⲁⲑⲁⲣⲟⲥ	ⲙⲛⲧⲕⲁⲑⲁⲣⲟⲥ	1
ⲡⲉⲓ ⲟⲉⲓⲕ	ⲟⲉⲓⲕ	1
ⲧϩⲟ	ⲧϩⲟ	1
ⲡ ⲣⲱⲙⲉ ⲉⲧ ⲙⲙⲁⲩ	ⲣⲱⲙⲉ	1
ⲛⲉ ⲉⲃⲟⲗ ϩⲛ ⲛⲉ ⲅⲣⲁⲫⲏ	ⲅⲣⲁⲫⲏ	1
ⲟⲩ ⲑⲩⲥⲓⲁ ⲧⲉ ⲙ ⲡ ⲛⲟⲩⲧⲉ	ⲑⲩⲥⲓⲁ	1
ⲟⲩ ⲙⲛⲧⲁⲧⲥⲟⲟⲩⲛ	ⲙⲛⲧⲁⲧⲥⲟⲟⲩⲛ	1
ⲕⲣⲓⲥⲡⲟⲥ	ⲕⲣⲓⲥⲡⲟⲥ	1
ⲛⲟⲃⲉ ⲛⲓⲙ ⲉⲧⲉⲣⲉ ⲡ ⲣⲱⲙⲉ ⲛⲁ ⲁⲁ ⲩ	ⲛⲟⲃⲉ	1
ⲩ ⲥⲟⲛ · ⲉ ϥ ϩⲙⲟⲟⲥ ⲉϩⲣⲁⲓ ⲉ ϥ ⲕⲱ ⲛ ⲣⲱ ϥ	ⲥⲟⲛ	1
ⲡ ⲛⲟⲩⲧⲉ ⲓⲏⲥⲟⲩⲥ ⲡⲉ ⲭⲣⲓⲥⲧⲟⲥ	ⲓⲏⲥⲟⲩⲥ	1
ⲃⲛⲧ	ⲃⲛⲧ	1
ⲕⲱϩ	ⲕⲱϩ	1
ⲛⲟϭ	ⲛⲟϭ	1
ⲕⲃⲁ	ⲕⲃⲁ	1
ϣⲉ ϣⲉ	ϣⲉ	1
ⲙⲏⲧ	ⲙⲏⲧ	1
ⲙⲟⲩ	ⲙⲟⲩ	1
ⲥⲁϥ	ⲥⲁϥ	1
ⲥⲁϩ	ⲥⲁϩ	1
ⲥⲟϭ	ⲥⲟϭ	1
ⲧⲱϩ	ⲧⲱϩ	1
ⲟⲙⲉ	ⲟⲙⲉ	1
ⲣⲏⲥ	ⲣⲏⲥ	1
ⲣⲙⲏ	ⲣⲙⲏ	1
ⲣⲣⲟ	ⲣⲣⲟ	1
ⲥⲃⲱ	ⲥⲃⲱ	1
ⲥⲙⲏ	ⲥⲙⲏ	1
ⲧⲙⲏ	ⲧⲙⲏ	1
ⲧⲡⲉ	ⲧⲡⲉ	1
ⲡⲉ ⲭⲣⲓⲥⲧⲟⲥ ⲓⲏⲥⲟⲩⲥ ⲡⲉⲛ ϫⲟⲉⲓⲥ	ⲓⲏⲥⲟⲩⲥ	1
ⲡⲉⲓ ⲙⲁ ⲛ ϫⲁⲓⲉ	ⲙⲁ	1
ⲛⲟⲩ ⲉⲓⲟⲧⲉ ⲉⲧ ϩⲛ ⲧ ⲥⲩⲛⲁⲅⲱⲅⲏ ⲛⲙⲙ ⲉ	ⲉⲓⲟⲧⲉ	1
ⲁϣ ⲛ ϣⲁϫⲉ	ⲁϣ	1
ⲛⲁⲓ ⲉⲧ ⲙⲙⲁⲩ ⲉⲧ ϥ ⲧⲁⲓⲟ ⲙⲙⲟ ⲟⲩ	ⲛⲁⲓ	1
ⲧ ⲁⲅⲁⲡⲏ	ⲁⲅⲁⲡⲏ	1
ⲧ ⲁⲅⲟⲣⲁ	ⲁⲅⲟⲣⲁ	1
ⲡ ϫⲱⲕ ⲛ ⲧ ⲙⲛⲧⲛⲟⲩⲧⲉ	ϫⲱⲕ	1
ⲡⲉ ⲧⲕⲁⲥ ⲉⲧ ϩⲓϫⲱ ⲓ	ⲧⲕⲁⲥ	1
ⲧ ⲁⲅⲱⲣⲁ	ⲁⲅⲱⲣⲁ	1
ⲡⲁⲓ ⲉⲛⲧ ⲁ ϥ ϫⲡⲟ ⲛ ϩⲣⲁⲓ ϩⲙ ⲡⲉϥ ⲥⲛⲟϥ ⲉⲧ ⲟⲩⲁⲁⲃ	ⲡⲁⲓ	1
ⲛⲉϥ ⲧⲟⲡⲟⲥ	ⲧⲟⲡⲟⲥ	1
ⲛ ϩⲏⲕⲉ ⲛⲧⲉ ⲡ ⲕⲟⲥⲙⲟⲥ	ϩⲏⲕⲉ	1
ϩⲉⲛ ⲙⲛⲧⲛⲟⲉⲓⲕ	ⲙⲛⲧⲛⲟⲉⲓⲕ	1
ⲟⲩ ⲙⲏⲏϣⲉ ⲛ ⲇⲁⲓⲙⲱⲛⲓⲟⲛ	ⲙⲏⲏϣⲉ	1
ⲡⲁ ⲙⲡϣⲁ	ⲙⲡϣⲁ	1
ⲛ ⲉⲧ ⲛⲁ ⲙⲟⲩⲟⲩⲧ ⲙ ⲡⲉⲧⲛ ⲥⲱⲙⲁ	ⲛ	1
ⲍⲉⲗⲫⲁ	ⲍⲉⲗⲫⲁ	1
ⲟⲩⲛⲁⲙ ⲙ ⲡ ϫⲟⲉⲓⲥ	ⲟⲩⲛⲁⲙ	1
ⲡ ⲕⲉ ⲛⲟϭ ⲙ ⲡⲁⲥⲭⲁ	ⲡⲁⲥⲭⲁ	1
ⲧ ⲁⲣⲉⲧⲏ	ⲁⲣⲉⲧⲏ	1
ⲡⲁ ⲟⲉⲓⲕ	ⲟⲉⲓⲕ	1
ϩⲁϩ ⲛϩⲏⲧ ⲟⲩ	ⲟⲩ	1
ⲡ ⲣⲱⲙⲉ ⲛⲧ ⲁ ϥ ⲉⲓ ϣⲁⲣⲟ ⲓ ⲛ ϣⲟⲣⲡ	ⲣⲱⲙⲉ	1
ⲛ ⲧⲟ ⲛ ⲛ ⲉⲧ ϩⲓⲧⲟⲩⲱ ⲟⲩ	ⲧⲟ	1
ⲫⲁⲣⲉⲥ ⲡⲁⲓ ⲉⲛⲧ ⲁ ⲑⲁⲙⲁⲣ ϫⲡⲟ ϥ ⲛ ⲓⲟⲩⲇⲁⲥ	ⲫⲁⲣⲉⲥ	1
ⲡⲁ ⲥⲙⲟⲧ	ⲥⲙⲟⲧ	1
ⲣⲉϥⲣⲛⲟⲃⲉ	ⲣⲉϥⲣⲛⲟⲃⲉ	1
ⲡⲁ ⲥⲡⲓⲣ	ⲥⲡⲓⲣ	1
ⲡ ⲕⲁⲕⲉ ⲙ ⲡⲉⲩ ⲥⲟⲟⲩⲛ ⲛ ⲛⲟⲩϫ	ⲕⲁⲕⲉ	1
ⲧⲟⲩ ⲙⲛⲧⲃⲁⲃⲉⲣⲱⲙⲉ	ⲙⲛⲧⲃⲁⲃⲉⲣⲱⲙⲉ	1
ⲛⲉ ⲥⲃⲟⲟⲩⲉ ⲛⲉ ⲛ ⲛⲉⲛ ⲉⲓⲟⲧⲉ	ⲥⲃⲟⲟⲩⲉ	1
ϩⲃⲥⲱ ⲉ ϥ ϭⲟⲟⲗⲉ ⲙⲙⲟ ϥ	ϩⲃⲥⲱ	1
ⲩ ⲙⲁ ⲛ ⲙϩⲁⲁⲩ	ⲙⲁ	1
ⲧⲉⲕ ⲡⲟⲣϣⲥ	ⲡⲟⲣϣⲥ	1
ⲡ ⲙⲁ ⲛ ⲛⲉ ⲥⲕⲉⲩⲏ	ⲙⲁ	1
ⲧⲉⲩ ⲁⲥⲟⲩ	ⲁⲥⲟⲩ	1
ⲛ ⲉⲧ ⲥⲟϣϥ ϩⲛ ⲧ ⲉⲕⲕⲗⲏⲥⲓⲁ	ⲛ	1
ⲡⲉϥ ⲙⲁ ⲛ ϣⲱⲡⲉ	ⲙⲁ	1
ⲓⲏⲥⲟⲩⲥ ⲡⲉ ⲭⲣⲓⲥⲧⲟⲥ ⲡⲉⲛ ϫⲟⲉⲓⲥ ⲡⲁⲓ ⲉⲃⲟⲗ ϩⲓⲧⲟⲟⲧ ϥ ⲡ ⲉⲟⲟⲩ ⲙ ⲡ ⲉⲓⲱⲧ ⲛⲙⲙⲁ ϥ ⲙⲛ ⲡⲉ ⲡⲛⲉⲩⲙⲁ ⲉⲧ ⲟⲩⲁⲁⲃ · ϣⲁ ⲛ ⲁⲓⲱⲛ ⲧⲏⲣ ⲟⲩ ⲛ ⲁⲓⲱⲛ	ⲓⲏⲥⲟⲩⲥ	1
ⲟⲩ ⲃⲗⲃⲓⲗⲉ ⲛ ϣⲗⲧⲙ	ⲃⲗⲃⲓⲗⲉ	1
ⲡ ⲉⲧ ⲙⲟⲟϣⲉ ⲛⲙⲙⲁ ⲕ	ⲡ	1
ⲛⲁ ⲡ ⲕⲟⲥⲙⲟⲥ	ⲛⲁ	1
ⲡ ⲉⲧ ϩⲁⲣⲁⲧ ϥ	ⲡ	1
ⲛⲉⲥ ⲛⲟⲩⲧⲉ	ⲛⲟⲩⲧⲉ	1
ϩⲉⲛ ⲙⲛⲧⲣⲉϥϯ	ⲙⲛⲧⲣⲉϥϯ	1
ⲣⲉϥϯϩⲉ	ⲣⲉϥϯϩⲉ	1
ⲛ ⲉⲧ ⲡⲓⲥⲧⲉⲩⲉ	ⲛ	1
ⲡ ⲉⲧ ϫⲱ	ⲡ	1
ⲡ ⲉⲃⲟⲧ ⲉⲡⲏⲡ	ⲉⲡⲏⲡ	1
ⲡ ⲉⲧ ⲙⲡⲉ ϥ ⲕⲁⲁ ⲥ ⲉ ⲡⲟⲗⲓⲧⲉⲩⲉ ϩⲙ ⲡ ⲕⲟⲥⲙⲟⲥ	ⲡ	1
ⲓⲉⲥⲥⲁⲓ ⲡ ⲉⲓⲱⲧ ⲛ ⲇⲁⲩⲉⲓⲇ	ⲓⲉⲥⲥⲁⲓ	1
ⲧ ϩⲟⲣⲙⲏ ⲛ ⲛ ⲇⲁⲓⲙⲱⲛ	ϩⲟⲣⲙⲏ	1
ⲓⲱϩⲁⲛⲛⲏⲥ ⲡⲉ ⲡ ⲃⲁⲡⲧⲓⲥⲧⲏⲥ	ⲓⲱϩⲁⲛⲛⲏⲥ	1
ⲛ ⲉⲧ ϣⲟⲟⲡ ⲕⲁⲕⲱⲥ	ⲛ	1
ⲍⲁⲭⲁⲓⲟⲥ	ⲍⲁⲭⲁⲓⲟⲥ	1
ⲛ ϭⲓⲛⲟⲩⲟⲟⲙ	ϭⲓⲛⲟⲩⲟⲟⲙ	1
ⲧⲉⲩ ⲥⲁⲧⲉ	ⲥⲁⲧⲉ	1
ⲧ ϭⲟⲙ ⲧⲏⲣ ⲥ ⲙ ⲡ ϫⲁϫⲉ	ϭⲟⲙ	1
ⲡⲛⲉⲩⲙⲁⲧⲓⲕⲟⲥ	ⲡⲛⲉⲩⲙⲁⲧⲓⲕⲟⲥ	1
ⲛ ⲧⲉⲗⲓⲟⲥ ⲛ ⲙ ⲙⲛⲧⲛⲁ	ⲧⲉⲗⲓⲟⲥ	1
ⲧⲉ ϩⲓⲏ ⲙ ⲡ ⲙⲁ	ϩⲓⲏ	1
ⲡⲉϥ ⲙⲟⲛⲟⲅⲉⲛⲏⲥ ⲛ ϣⲏⲣⲉ ⲓⲏⲥⲟⲩⲥ ⲡⲉ ⲭⲣⲓⲥⲧⲟⲥ ⲡⲉⲛ ϫⲟⲉⲓⲥ ⲡ ⲉⲛⲧ ⲁ ⲡ ⲧⲏⲣϥ ϣⲱⲡⲉ ⲉⲃⲟⲗ ϩⲓⲧⲟⲟⲧ ϥ	ⲓⲏⲥⲟⲩⲥ	1
ⲧⲉϥ ⲙⲛⲧϩⲗⲗⲟ	ⲙⲛⲧϩⲗⲗⲟ	1
ⲟⲩ ⲡⲓⲥⲧⲟⲥ	ⲡⲓⲥⲧⲟⲥ	1
ⲡ ⲛⲟϭⲛⲉϭ ⲛ ⲧⲁ ⲙⲁⲁⲩ	ⲛⲟϭⲛⲉϭ	1
ⲛ ⲉⲧⲉ ⲙⲉϣϣⲉ	ⲛ	1
ⲡⲉⲥ ⲧⲟⲩⲉⲓⲟ	ⲧⲟⲩⲉⲓⲟ	1
ⲛ ⲛ ⲉⲧ ⲙⲉ ⲙⲙⲟ ϥ	ⲛ	1
ⲡ ϣⲟⲩϣⲧ	ϣⲟⲩϣⲧ	1
ⲧ ⲙⲛⲧⲙⲁⲓϩⲟⲙⲛⲧ	ⲙⲛⲧⲙⲁⲓϩⲟⲙⲛⲧ	1
ⲛⲓ ⲕⲟⲟⲩⲉ ⲧⲏⲣ ⲟⲩ ⲉⲧ ⲉⲓⲛⲉ ⲙⲙⲟ ϥ	ⲕⲟⲟⲩⲉ	1
ⲙⲛⲧⲣⲉϥϩⲉⲧⲃⲯⲩⲭⲏ	ⲙⲛⲧⲣⲉϥϩⲉⲧⲃⲯⲩⲭⲏ	1
ⲛ ⲉⲧ ⲟ ⲙ ⲙⲛⲧⲣⲉ ⲉⲣⲟ ⲕ	ⲛ	1
ⲛⲁϣⲧⲉ	ⲛⲁϣⲧⲉ	1
ⲕⲱϩⲧ ⲉⲧ ⲙⲟⲩϩ	ⲕⲱϩⲧ	1
ⲟⲩ ⲕⲁϩ ⲛ ⲃⲣⲣⲉ	ⲕⲁϩ	1
ⲧⲉⲩ ϩⲓⲏ ⲙ ⲡ ⲙⲧⲟ ⲉⲃⲟⲗ ⲙ ⲡ ⲛⲟⲩⲧⲉ	ϩⲓⲏ	1
ⲛⲉⲕ ⲟⲩⲣⲏⲏⲧⲉ	ⲟⲩⲣⲏⲏⲧⲉ	1
ⲛ ⲛⲟⲃⲉ ⲙ ⲡ ⲕⲟⲥⲙⲟⲥ	ⲛⲟⲃⲉ	1
ⲡⲉ ϩⲣⲟⲩⲃⲃⲁⲉⲓ	ϩⲣⲟⲩⲃⲃⲁⲉⲓ	1
ⲡⲉ ϩⲟⲟⲩ ⲉⲧ ⲕ ⲛⲁ ϫⲓ ⲛ ⲧ ⲥⲱϣⲉ ⲛⲧⲟⲟⲧ ⲥ ⲛ ⲛⲟⲉⲙⲓⲛ ⲁⲩⲱ ⲛⲧⲟⲟⲧ ⲥ ⲛ ϩⲣⲟⲩⲑ ⲧ ⲙⲱⲁⲃⲓⲧⲏⲥ ⲧ ϩⲓⲙⲉ ⲙ ⲡ ⲉⲛⲧ ⲁ ϥ ⲙⲟⲩ	ϩⲟⲟⲩ	1
ⲟⲩ ⲉⲥⲩⲭⲓⲁ	ⲉⲥⲩⲭⲓⲁ	1
ⲧⲁ ⲥⲃⲱ	ⲥⲃⲱ	1
ⲟⲩ ⲥⲟⲫⲓⲁ ⲇⲉ ⲉ ⲛ ⲧⲁ ⲡⲉⲓ ⲁⲓⲱⲛ ⲁⲛ ⲧⲉ ⲟⲩⲇⲉ ⲛ ⲧⲁ ⲛ ⲁⲣⲭⲱⲛ ⲁⲛ ⲧⲉ ⲙ ⲡⲉⲓ ⲁⲓⲱⲛ ⲛⲁⲓ ⲉⲧ ⲛⲁ ⲟⲩⲱⲥϥ	ⲥⲟⲫⲓⲁ	1
ⲡ ⲉⲧ ⲟⲩⲱϣ ⲉ ⲟⲩⲁϩ ϥ ⲛⲥⲱ ⲓ	ⲡ	1
ⲙⲏⲧ ⲛ ϣⲉ ⲛ ϩⲟⲗⲟⲕⲟⲧⲧⲓⲛⲟⲥ	ϩⲟⲗⲟⲕⲟⲧⲧⲓⲛⲟⲥ	1
ⲣⲱⲙⲉ ⲉ ϥ ⲛⲏⲩ ϣⲁⲣⲟ ⲓ	ⲣⲱⲙⲉ	1
ⲛ ⲉⲧ ϥ ⲉⲓⲣⲉ ⲙⲙⲟ ⲟⲩ	ⲛ	1
ⲑⲁⲙⲁⲣ	ⲑⲁⲙⲁⲣ	1
ⲟⲩ ⲗⲉⲗⲟⲩ ⲉ ⲥ ϩⲙ ⲡ ⲏⲓ ⲛⲙⲙ ⲉ	ⲗⲉⲗⲟⲩ	1
ⲛ ⲉⲧ ⲛⲁ ⲟⲩϫⲁⲓ	ⲛ	1
ⲡⲉϥ ϫⲱⲕ ⲉⲃⲟⲗ	ϫⲱⲕ	1
ⲡⲁ ⲛⲉⲓ ⲡⲁⲣⲧⲁⲗⲏⲥ	ⲡⲁ	1
ⲓⲱϩⲁⲛⲛⲏⲥ ⲡ ⲃⲁⲡϯⲥⲧⲏⲥ · ⲡ ⲉⲧⲉ ⲙⲡ ϥ ⲧⲱⲟⲩⲛ ϩⲙ ⲡⲉ ϫⲡⲟ ⲛ ⲛⲉ ϩⲓⲟⲟⲙⲉ · ⲛϭⲓ ⲡ ⲉⲧ ⲟ ⲛ ⲛⲟϭ ⲉⲣⲟ ϥ	ⲓⲱϩⲁⲛⲛⲏⲥ	1
ⲡ ϣⲁϫⲉ ⲛ ⲛ ⲉⲧ ϫⲟⲥⲉ ⲛ ϩⲏⲧ	ϣⲁϫⲉ	1
ⲛ ϫⲱϩⲙ	ϫⲱϩⲙ	1
ⲡⲉ ⲣⲡⲉ ⲙ ⲡ ⲛⲟⲩⲧⲉ	ⲣⲡⲉ	1
ⲗⲁⲁⲩ ⲛϩⲏⲧ ⲧⲏⲩⲧⲛ	ⲗⲁⲁⲩ	1
ⲡ ⲙⲁ ⲉⲧⲉ ⲣ ⲁ ⲙⲟⲩ ⲛϩⲏⲧ ϥ	ⲙⲁ	1
ⲡⲁ ⲁⲡⲟⲗⲗⲱ	ⲁⲡⲟⲗⲗⲱ	1
ⲡ ⲉⲛⲧ ⲁ ϥ ⲥⲱⲛⲧ ⲛ ⲛⲕⲁ ⲛⲓⲙ ⲓⲏⲥⲟⲩⲥ ⲡ ⲉⲧ ⲥⲙⲁⲙⲁⲁⲧ ϣⲁ ⲉⲛⲉϩ ⲛ ⲉⲛⲉϩ	ⲓⲏⲥⲟⲩⲥ	1
ⲛ ϩⲗⲗⲱ	ϩⲗⲗⲱ	1
ϩⲣⲟⲩⲑ ⲧⲉⲕ ϩⲙϩⲁⲗ	ϩⲣⲟⲩⲑ	1
ⲛ ϩⲟⲧⲉ	ϩⲟⲧⲉ	1
ⲛ ϫⲁⲓⲉ	ϫⲁⲓⲉ	1
ϩⲉⲛ ⲅⲣⲁⲙⲙⲁⲧⲉⲩⲥ ⲉ ⲩ ϯⲧⲱⲛ ⲛⲙⲙⲁ ⲩ	ⲅⲣⲁⲙⲙⲁⲧⲉⲩⲥ	1
ⲡⲉⲛ ⲕⲁϩ	ⲕⲁϩ	1
ⲛ ϫⲣⲟⲡ	ϫⲣⲟⲡ	1
ⲡⲉⲛ ⲥⲁϩ	ⲥⲁϩ	1
ⲡ ⲙⲁⲓⲛⲟⲩⲧⲉ	ⲙⲁⲓⲛⲟⲩⲧⲉ	1
ⲧⲁ ⲙⲛⲧϩⲁⲣϣϩⲏⲧ	ⲙⲛⲧϩⲁⲣϣϩⲏⲧ	1
ⲙⲁⲥⲧⲛⲟⲩⲧⲉ ⲛ ⲣⲉϥϣⲱⲥ	ⲙⲁⲥⲧⲛⲟⲩⲧⲉ	1
ⲙⲉϣⲉ ⲛⲓⲙ ⲛ ⲁⲣⲭⲓⲙⲁⲛⲇⲣⲓⲧⲏⲥ	ⲙⲉϣⲉ	1
ⲙⲁ ⲛ ϯϩⲁⲡ	ⲙⲁ	1
ⲡ ⲣⲟ ⲙ ⲡ ⲡⲁⲗⲗⲁϯⲟⲛ	ⲣⲟ	1
ⲟⲩ ϣⲁϫⲉ ⲛ ϣⲗⲟϥ	ϣⲁϫⲉ	1
ⲡⲉ ⲙⲧⲟ ⲉⲃⲟⲗ ⲛ ⲛⲉ ⲡⲣⲉⲥⲃⲩⲧⲉⲣⲟⲥ ⲙ ⲡ ⲗⲁⲟⲥ	ⲙⲧⲟ	1
ⲧⲉⲓ ⲉⲣⲏⲙⲁ	ⲉⲣⲏⲙⲁ	1
ⲧ ⲁⲛⲁⲅⲕⲏ ⲛ ⲟⲩ ⲡⲗⲏⲅⲏ	ⲁⲛⲁⲅⲕⲏ	1
ⲧⲉⲩ ⲁϭⲟⲗⲧⲉ	ⲁϭⲟⲗⲧⲉ	1
ⲟⲩ ⲡⲉⲓⲑⲉ ⲛ ⲥⲟⲫⲓⲁ ⲛ ϣⲁϫⲉ	ⲡⲉⲓⲑⲉ	1
ⲡ ⲣⲁⲛ ⲙ ⲡ ⲣⲱⲙⲉ ⲉⲛⲧ ⲁ ϥ ⲉⲓⲣⲉ ⲛⲙⲙⲁ ⲓ ⲙ ⲡ ϩⲟⲟⲩ	ⲣⲁⲛ	1
ⲓⲏⲥⲟⲩⲥ ⲡⲉⲛ ϫⲟⲉⲓⲥ · ⲡⲁⲓ ⲉⲧⲉ ⲡⲱϥ ⲡⲉ ⲡ ⲉⲟⲟⲩ ⲙⲛ ⲡ ⲁⲙⲁϩⲧⲉ ϣⲁ ⲉⲛⲉϩ ⲛ ⲉⲛⲉϩ	ⲓⲏⲥⲟⲩⲥ	1
ⲡ ⲏⲓ ⲉ ⲧⲉⲧⲛ ⲛⲁ ⲃⲱⲕ ⲉϩⲟⲩⲛ ⲉⲣⲟ ϥ	ⲏⲓ	1
ⲡ ⲁⲡⲟⲥⲧⲟⲗⲟⲥ ⲉⲧ ⲟⲩⲁⲁⲃ	ⲁⲡⲟⲥⲧⲟⲗⲟⲥ	1
ⲡⲓ ⲕⲩⲣⲓⲝ	ⲕⲩⲣⲓⲝ	1
ⲡ ⲉⲧⲉ ⲧⲛ ⲟⲩⲁϣ ϥ	ⲡ	1
ⲧ ϩⲓⲉⲣⲟⲩⲥⲁⲗⲏⲙ ⲛ ⲧ ⲡⲉ	ϩⲓⲉⲣⲟⲩⲥⲁⲗⲏⲙ	1
ⲡⲉⲛ ⲣⲙⲛⲥⲟⲟⲩⲛ	ⲣⲙⲛⲥⲟⲟⲩⲛ	1
ⲧ ϩⲏ ⲛ ⲛ ϭⲓⲛⲟⲩⲟⲟⲙ	ϩⲏ	1
ⲛⲉ ⲫⲁⲣⲣⲓⲥⲁⲓⲟⲥ	ⲫⲁⲣⲣⲓⲥⲁⲓⲟⲥ	1
ⲟⲩ ⲗⲁⲟⲥ ⲉ ⲛ ⲧⲉ ⲥⲟⲟⲩⲛ ⲙⲙⲟ ϥ ⲁⲛ ⲛ ⲥⲁϥ ⲙⲛ ϣⲙⲧ	ⲗⲁⲟⲥ	1
ⲑⲱⲙⲁⲥ	ⲑⲱⲙⲁⲥ	1
ⲗⲁⲁⲩ ⲛ ⲁⲣⲭⲱⲛ ⲛⲧⲉ ⲡⲉⲓ ⲁⲓⲱⲛ	ⲗⲁⲁⲩ	1
ⲛⲉϥ ϣⲏⲣⲉ ⲧⲏⲣ ⲟⲩ	ϣⲏⲣⲉ	1
ⲛⲁ ⲟⲩⲉⲣⲏⲧⲉ	ⲟⲩⲉⲣⲏⲧⲉ	1
ⲡ ⲕⲉ ⲟⲩⲁ ⲉⲧ ⲁϩⲉ ⲡ ⲣⲱⲙⲉ ⲉⲣⲁⲧ ϥ	ⲟⲩⲁ	1
ⲡⲉⲛ ⲡⲉⲧⲟⲩⲁⲁⲃ ⲛ ⲉⲓⲱⲧ ⲉⲧ ⲧⲁⲓⲏⲩ ⲕⲁⲧⲁ ⲥⲙⲟⲧ ⲛⲓⲙ ⲁⲡⲁ ⲟⲛⲛⲟⲫⲣⲓⲟⲥ ⲡ ⲁⲛⲁⲭⲱⲣⲓⲧⲏⲥ ⲛⲧ ⲁ ϥ ϫⲱⲕ ⲉⲃⲟⲗ ⲙ ⲡⲉϥ ⲃⲓⲟⲥ ⲛ ⲥⲟⲩⲙⲛⲧⲧⲁⲥⲉ ⲙ ⲡ ⲉⲃⲟⲧ ⲡⲁⲱⲛⲉ ϩⲛ ⲟⲩ ⲉⲓⲣⲏⲛⲏ ⲛⲧⲉ ⲡ ⲛⲟⲩⲧⲉ	ⲟⲛⲛⲟⲫⲣⲓⲟⲥ	1
ⲛ ϯϩⲉ	ϯϩⲉ	1
ⲡⲉ ⲥⲧⲣⲁⲧⲉⲩⲙⲁ ⲧⲏⲣ ϥ	ⲥⲧⲣⲁⲧⲉⲩⲙⲁ	1
ⲡⲁⲓ ⲉⲧ ϭⲱϣⲧ ⲉϫⲱ ⲛ	ⲡⲁⲓ	1
ⲡ ⲉⲛⲧ ⲁ ϥ ϫⲡⲉ ⲡⲉ ⲑⲃⲃⲓⲟ ⲛⲁ ϥ	ⲡ	1
ⲡ ⲙⲁ ⲉⲧ ϥ ⲛϩⲏⲧ ϥ	ⲙⲁ	1
ⲡⲉ ⲟⲩⲟⲉⲓϣ ⲛⲧ ⲁ ϥ ⲡⲱⲧ	ⲟⲩⲟⲉⲓϣ	1
ⲛⲉⲧⲛ ⲏⲓ	ⲏⲓ	1
ⲛ ϣⲏⲛ	ϣⲏⲛ	1
ⲛ ϩⲏⲧ	ϩⲏⲧ	1
ⲛ ϫⲏⲣ	ϫⲏⲣ	1
ⲛ ϭⲟⲗ	ϭⲟⲗ	1
ⲧⲉⲕ ⲧⲁⲡⲣⲟ	ⲧⲁⲡⲣⲟ	1
ⲡ ⲕⲱϩⲧ ⲛ ⲁⲧⲱϣⲙ	ⲕⲱϩⲧ	1
ⲡ ϩⲱⲱⲕ ⲛ ⲧ ⲡⲓⲥⲧⲓⲥ	ϩⲱⲱⲕ	1
ⲡ ⲣⲱⲙⲉ ⲉⲧ ⲟⲩⲁⲁⲃ	ⲣⲱⲙⲉ	1
ⲟⲩ ⲇⲓⲕⲁⲓⲟⲥⲩⲛⲏ	ⲇⲓⲕⲁⲓⲟⲥⲩⲛⲏ	1
ⲉⲟⲟⲩ ⲛⲓⲙ	ⲉⲟⲟⲩ	1
ⲛ ⲣⲉϥϯ ⲉⲧ ⲣⲟⲟⲩⲧ	ⲣⲉϥϯ	1
ⲛ ⲁⲧϩⲏⲧ ⲉⲧ ⲣϩⲟⲩⲟ ⲉⲙⲁⲧⲉ ϩⲛ ϩⲉⲛ ⲙⲛⲧⲥⲟϭ	ⲁⲧϩⲏⲧ	1
ⲟⲩⲏⲣ ⲙⲙⲁⲩ ⲛ ⲟⲉⲓⲕ	ⲟⲩⲏⲣ	1
ⲡⲉ ⲡⲛⲉⲩⲙⲁⲧⲓⲕⲟⲥ	ⲡⲛⲉⲩⲙⲁⲧⲓⲕⲟⲥ	1
ⲓⲟⲩⲇⲁ	ⲓⲟⲩⲇⲁ	1
ⲙⲕⲁϩ ⲛ ϩⲏⲧ ⲛⲓⲙ	ⲙⲕⲁϩ	1
ⲡⲉⲛ ⲉⲓⲱⲧ ⲙⲛ ⲧⲉⲛ ⲙⲁⲁⲩ ⲉⲛⲧ ⲁ ⲩ ϫⲡⲟ ⲛ	ⲉⲓⲱⲧ	1
ⲣⲉϥϩⲱϥⲧ	ⲣⲉϥϩⲱϥⲧ	1
ⲧ ⲡⲟⲛⲏⲣⲓⲁ ⲉⲧ ϩⲁ ⲙ ⲡⲏⲩⲉ	ⲡⲟⲛⲏⲣⲓⲁ	1
ⲛ ⲇⲩⲛⲁⲙⲓⲥ ⲙ ⲡ ⲕⲁⲕⲉ	ⲇⲩⲛⲁⲙⲓⲥ	1
ⲡⲉⲩ ϥⲛⲧ	ϥⲛⲧ	1
ⲧ ϩⲏ ⲙ ⲡⲉ ⲭⲣⲓⲥⲧⲟⲥ ⲙⲛ ⲛⲉϥ ⲁⲅⲅⲉⲗⲟⲥ ⲧⲏⲣ ⲟⲩ	ϩⲏ	1
ⲁⲡⲁ ϩⲩⲡⲏⲣⲉⲭⲓⲟⲥ	ϩⲩⲡⲏⲣⲉⲭⲓⲟⲥ	1
ⲛⲁⲓ ⲉⲧ ϥ ⲙⲉⲉⲩⲉ ⲉ ⲛ ⲇⲱⲣⲟⲛ ⲙ ⲡ ⲛⲟⲩⲧⲉ ⲉⲃⲟⲗ ⲛϩⲏⲧ ⲟⲩ	ⲛⲁⲓ	1
ⲛ ⲉⲛⲧ ⲁ ⲙⲱⲩⲥⲏⲥ ⲟⲩⲉϩⲥⲁϩⲛⲉ ⲙⲙⲟ ⲟⲩ	ⲛ	1
ⲓⲱⲥⲏⲫ	ⲓⲱⲥⲏⲫ	1
ⲥⲟⲡ ⲥⲛⲁⲩ	ⲥⲟⲡ	1
ⲡⲟⲣⲫⲩⲣⲁ ⲛⲓⲙ ⲛ ⲣⲣⲟ ⲛⲧⲉ ⲡⲉⲓ ⲕⲟⲥⲙⲟⲥ	ⲡⲟⲣⲫⲩⲣⲁ	1
ⲡⲁ ϣⲏⲣⲉ · ϩⲙ ⲡ ϫⲟⲉⲓⲥ	ϣⲏⲣⲉ	1
ⲡⲉⲧⲛ ⲟⲩϫⲁⲓ	ⲟⲩϫⲁⲓ	1
ⲙ ⲙⲁⲑⲏⲧⲏⲥ ⲛ ⲛⲉ ⲫⲁⲣⲓⲥⲥⲁⲓⲟⲥ	ⲙⲁⲑⲏⲧⲏⲥ	1
ⲕⲉ ϣⲏⲙ ⲇⲉ ⲛ ⲧⲃⲧ	ϣⲏⲙ	1
ⲩ ⲥⲁⲣⲝ ⲛ ⲟⲩⲱⲧ	ⲥⲁⲣⲝ	1
ⲡ ⲉⲧⲉⲣⲉ ⲡⲉϥ ϩⲱⲃ ⲛⲁ ⲣⲱⲕϩ	ⲡ	1
ⲛⲉⲩ ⲁϭⲟⲗⲧⲉ	ⲁϭⲟⲗⲧⲉ	1
ⲡⲁ ⲉⲓⲱⲧ ⲉⲧ ⲟⲩⲁⲁⲃ	ⲉⲓⲱⲧ	1
ⲟⲩⲉⲓ ⲛ ⲛⲉⲕ ϩⲙϩⲁⲗ	ⲟⲩⲉⲓ	1
ⲡⲉ ⲡⲛⲉⲩⲙⲁ ⲛ ⲙⲡⲟ ⲁⲩⲱ ⲛ ⲁⲗ	ⲡⲛⲉⲩⲙⲁ	1
ⲡ ⲉⲛⲧ ⲁ ϥ ϩⲟⲩⲗⲁ ⲉⲣⲟ ϥ ⲛ ϥⲧⲟⲩ ⲕⲱⲃ	ⲡ	1
ⲛ ϩⲗⲗⲟⲓ ⲛⲉⲛ ⲉⲓⲟⲧⲉ	ϩⲗⲗⲟⲓ	1
ⲛ ⲉⲧ ⲛⲕⲟⲧⲕ ⲛ ⲧⲉ ⲩϣⲏ	ⲛ	1
ⲡⲉⲓ ⲗⲟⲟⲩ ϭⲉ ⲛ ⲃⲛⲛⲉ	ⲗⲟⲟⲩ	1
ⲡⲉϥ [.....]	[.....]	1
ⲕⲗⲁϥⲧ	ⲕⲗⲁϥⲧ	1
ⲧⲉⲕ ⲙⲛⲧⲣⲙⲙⲁⲟ	ⲙⲛⲧⲣⲙⲙⲁⲟ	1
ⲧ ⲡⲛⲛⲏ ⲙ ⲡ ⲣⲟ	ⲡⲛⲛⲏ	1
ⲡⲉⲕ ϩⲁⲣⲡⲁⲍⲉ	ϩⲁⲣⲡⲁⲍⲉ	1
ⲡ ϫⲟⲉⲓⲥ ⲡⲉ ⲙ ⲡ ⲕⲉ ⲥⲁⲃⲃⲁⲧⲟⲛ	ϫⲟⲉⲓⲥ	1
ⲡⲉϥ ⲃⲓⲟⲥ	ⲃⲓⲟⲥ	1
ⲧⲁ ⲛⲉ ⲅⲣⲁⲙⲙⲁⲧⲉⲩⲥ ⲙⲛ ⲛⲉ ⲫⲁⲣⲓⲥⲥⲁⲓⲟⲥ	ⲧⲁ	1
ⲡ ⲉⲛⲧ ⲁ ϥ ⲧⲣⲉ ⲡⲉϥ ⲥⲟⲟⲩⲛ ⲣⲟⲩⲟⲉⲓⲛ ϩⲙ ⲙⲁ ⲛⲓⲙ	ⲡ	1
ⲡ ⲣⲟ ⲙ ⲡⲉϥ ⲏⲓ	ⲣⲟ	1
ⲡ ⲙⲉϩⲥⲛⲁⲩ	ⲙⲉϩⲥⲛⲁⲩ	1
ⲛⲉⲩ ⲉⲣⲏⲧ	ⲉⲣⲏⲧ	1
ⲡⲉⲕ ⲥⲡⲉⲣⲙⲁ ⲉⲧⲉⲣⲉ ⲡ ϫⲟⲉⲓⲥ ⲛⲁ ⲧⲁⲁ ϥ ⲛⲁ ⲕ ⲉⲃⲟⲗ ϩⲛ ⲧⲉⲓ ϣⲉⲉⲣⲉ ϣⲏⲙ	ⲥⲡⲉⲣⲙⲁ	1
ⲛ ⲉⲧⲉ ⲩⲛⲧⲁ ⲥ ⲥⲉ ⲧⲏⲣ ⲟⲩ	ⲛ	1
ⲛⲉⲩ ⲙⲟϫϩ	ⲙⲟϫϩ	1
ⲡⲉϥ ⲙⲡϣⲁ	ⲙⲡϣⲁ	1
ⲧⲁ ⲁⲅⲁⲡⲏ	ⲁⲅⲁⲡⲏ	1
ⲛ ⲁⲧϭⲟⲙ	ⲁⲧϭⲟⲙ	1
ⲕⲟⲙⲉⲥ	ⲕⲟⲙⲉⲥ	1
ⲕⲟⲩⲛⲥ	ⲕⲟⲩⲛⲥ	1
ⲧ ⲡⲟⲛⲏⲣⲓⲁ ⲙ ⲡ ⲡⲟⲛⲏⲣⲟⲥ ⲛ ⲣⲱⲙⲉ	ⲡⲟⲛⲏⲣⲓⲁ	1
ⲛⲉⲩ ⲕⲟⲧⲥ	ⲕⲟⲧⲥ	1
ⲧ ⲙⲏⲧⲉ ⲛ ϫⲱ ⲕ	ⲙⲏⲧⲉ	1
ⲡⲉϥ ⲕⲗⲟⲙ	ⲕⲗⲟⲙ	1
ⲡⲁϭⲥⲉ	ⲡⲁϭⲥⲉ	1
ⲡⲉϥ ⲙⲁⲕϩ	ⲙⲁⲕϩ	1
ⲡ ⲡⲟⲛⲏⲣⲟⲥ ⲛ ⲣⲱⲙⲉ	ⲡⲟⲛⲏⲣⲟⲥ	1
ⲛⲉⲩ ⲛⲟⲃⲉ	ⲛⲟⲃⲉ	1
ⲕⲩⲣⲟⲥ	ⲕⲩⲣⲟⲥ	1
ⲧ ϩⲟⲧⲉ ⲙⲛⲛⲥⲁ ⲧ ⲁⲛⲁⲥⲧⲁⲥⲓⲥ	ϩⲟⲧⲉ	1
ⲡ ⲉⲧ ⲡⲟⲣⲛⲉⲩⲉ	ⲡ	1
ⲛⲉⲩ ⲟⲩⲱϣ	ⲟⲩⲱϣ	1
ⲡⲉϥ ⲟⲉⲓⲕ	ⲟⲉⲓⲕ	1
ⲡⲉϥ ⲟⲩⲟⲓ	ⲟⲩⲟⲓ	1
ⲛ ⲉⲧⲉ ⲙⲉ ϣϣⲉ	ⲛ	1
ⲗⲁⲁⲩ ⲙ ⲙⲛⲧϫⲁⲥⲓϩⲏⲧ	ⲗⲁⲁⲩ	1
ⲛ ⲉⲛⲧ ⲁ ⲩ ⲕⲗⲏⲣⲟⲛⲟⲙⲉⲓ ⲉⲛⲉϩ ⲛ ⲧ ⲙⲛⲧⲣⲣⲟ ⲙ ⲡ ⲛⲟⲩⲧⲉ	ⲛ	1
ⲡⲉϥ ⲥⲛⲟϥ	ⲥⲛⲟϥ	1
ⲡ ⲕⲱⲧ ⲧⲏⲣ ϥ ⲛ ⲧ ⲙⲛⲧⲙⲟⲛⲁⲭⲟⲥ	ⲕⲱⲧ	1
ⲡⲉϥ ⲥⲙⲟⲧ	ⲥⲙⲟⲧ	1
ⲡⲉϥ ⲥⲙⲟⲩ	ⲥⲙⲟⲩ	1
ⲡⲉϥ ⲧⲁⲓⲟ	ⲧⲁⲓⲟ	1
ⲡ ⲕⲉ ⲉⲓ ⲉⲃⲟⲗ ⲙ ⲡ ϣⲁϫⲉ	ⲉⲓ	1
ⲛ ⲉⲧ ⲛⲙⲙⲁ ϥ ⲛⲙ ⲡ ⲙⲛⲧⲥⲛⲟⲟⲩⲥ	ⲛ	1
ⲙⲛⲧⲥⲛⲟⲟⲩⲥ ⲉⲃⲟⲗ [ ⲛϩⲏⲧ ⲟⲩ ⲛⲁⲓ ⲛⲧ ⲁ ϥ ϯ ⲡⲓⲛⲟⲩ ⲛⲉ ⲁⲡⲟⲥⲧⲟⲗⲟⲥ ]	ⲙⲛⲧⲥⲛⲟⲟⲩⲥ	1
ⲟⲩ ⲥⲧⲱⲧ ⲉ ⲛⲁϣⲱ ϥ	ⲥⲧⲱⲧ	1
ⲡⲉⲕ ⲙⲁ ⲛ ⲉⲗⲟⲟⲗⲉ	ⲙⲁ	1
ⲟⲩ ⲡⲛⲉⲩⲙⲁ	ⲡⲛⲉⲩⲙⲁ	1
ϩⲟⲓⲛⲉ ⲛ ⲛⲉ ⲅⲣⲁⲙⲙⲁⲧⲉⲩⲥ ⲉ ⲁ ⲩ ⲉⲓ ⲉⲃⲟⲗ ϩⲛ ⲧ ϩⲓⲉⲣⲟⲩⲥⲁⲗⲏⲙ	ϩⲟⲓⲛⲉ	1
ϩⲉⲛ ⲥⲃⲟⲟⲩⲉ ⲛ ⲉⲛⲧⲟⲗⲏ ⲛ ⲣⲱⲙⲉ	ⲥⲃⲟⲟⲩⲉ	1
ⲡⲉⲕ ⲃⲟⲏⲑⲟⲥ	ⲃⲟⲏⲑⲟⲥ	1
ⲉⲡⲏⲣⲉⲓⲁ ⲛⲓⲙ ⲛⲧⲉ ⲡ ϫⲁϫⲉ ⲉⲧ ϯ ⲟⲩⲃⲏ ⲛ ⲛ ⲟⲩⲟⲉⲓϣ ⲛⲓⲙ	ⲉⲡⲏⲣⲉⲓⲁ	1
ⲛ ⲉⲩⲁⲅⲅⲉⲗⲓⲟⲛ ⲙ ⲡⲉⲛ ϫⲟⲉⲓⲥ ⲓⲏⲥⲟⲩⲥ ⲡⲉ ⲭⲣⲓⲥⲧⲟⲥ	ⲉⲩⲁⲅⲅⲉⲗⲓⲟⲛ	1
ⲟⲩ ⲛⲟⲩⲧⲉ ⲉ ϥ ⲟⲛϩ	ⲛⲟⲩⲧⲉ	1
ⲡ ⲡⲉⲧⲟⲩⲁⲁⲃ ⲡ ⲑⲉⲟⲗⲟⲅⲟⲥ ⲓⲱϩⲁⲛⲛⲏⲥ · ⲡ ϩⲙϩⲁⲗ ⲙ ⲡ ⲛⲟⲩⲧⲉ	ⲓⲱϩⲁⲛⲛⲏⲥ	1
ϩⲉⲛ ϣⲁϫⲉ	ϣⲁϫⲉ	1
ⲡ ⲉⲧ ⲥⲏϩ	ⲡ	1
ⲡ ⲉⲧ ⲛⲏⲩ	ⲡ	1
ϥⲧⲟⲟⲩϣⲉ ⲛ ⲕⲉⲛⲧⲏⲛⲁⲣⲓⲟⲛ ⲛ ϩⲁⲧ	ⲕⲉⲛⲧⲏⲛⲁⲣⲓⲟⲛ	1
ⲓⲏⲥⲟⲩⲥ · ⲡⲁⲓ ⲛⲧ ⲁ ϥ ϫⲓ ⲛ ⲟⲩ ⲙⲟⲣⲫⲏ ⲛ ϩⲙϩⲁⲗ ⲉⲧⲃⲏⲏⲧ ⲛ	ⲓⲏⲥⲟⲩⲥ	1
ⲡ ⲉⲧⲉ ⲙⲡ ϥ ϯⲧⲉⲟⲩⲱ ⲛ ⲛ ϩⲏⲕⲉ ⲛⲁ ⲩ	ⲡ	1
ⲡⲉ ⲙⲧⲟ ⲉⲃⲟⲗ ⲛ ⲛⲉⲛ ⲃⲁⲗ	ⲙⲧⲟ	1
ϩⲉⲛ ϣⲗⲟϥ	ϣⲗⲟϥ	1
ϩⲉⲛ ϣⲗⲏⲗ	ϣⲗⲏⲗ	1
ⲗⲟⲓϭⲉ	ⲗⲟⲓϭⲉ	1
ⲧ ⲅⲁⲗⲓⲗⲁⲓⲁ ⲧⲏⲣ ⲥ	ⲅⲁⲗⲓⲗⲁⲓⲁ	1
ϩⲉⲛ ϩⲓⲥⲉ	ϩⲓⲥⲉ	1
ϩⲉⲛ ϩⲱⲧⲃ	ϩⲱⲧⲃ	1
ⲡⲉϥ ϩⲟⲩⲙⲓⲥⲉ	ϩⲟⲩⲙⲓⲥⲉ	1
ϭⲉ ⲛⲟⲩⲧⲉ	ⲛⲟⲩⲧⲉ	1
ⲧⲟⲩ ⲧⲁⲡⲣⲟ ⲉⲧ ⲙⲉϩ ⲛ ⲥⲁϩⲟⲩ ϩⲓ ⲥⲓϣⲉ	ⲧⲁⲡⲣⲟ	1
ⲣⲱⲙⲉ ⲛ ⲣⲉϥⲧⲱϩ	ⲣⲱⲙⲉ	1
ⲛⲟⲩ ϩⲟⲉⲓⲧⲉ	ϩⲟⲉⲓⲧⲉ	1
ϩⲉⲛ ϯⲧⲱⲛ	ϯⲧⲱⲛ	1
ⲟⲩ ⲡⲛⲉⲩⲙⲁ ⲙ ⲙⲛⲧⲣⲙⲣⲁϣ	ⲡⲛⲉⲩⲙⲁ	1
ⲡ ϫⲓⲟⲩⲉ	ϫⲓⲟⲩⲉ	1
ⲡⲁ ⲕⲉ ⲙⲟⲩ	ⲙⲟⲩ	1
ⲛ ⲉⲧ ⲧⲁϫⲣⲏⲩ ⲇⲉ ϩⲓⲧⲛ ⲧ ⲡⲓⲥⲧⲓⲥ	ⲛ	1
ⲧⲟⲩ ⲙⲁⲥⲧⲓⲅⲝ	ⲙⲁⲥⲧⲓⲅⲝ	1
ⲩ ⲧⲟⲉⲓⲥ	ⲧⲟⲉⲓⲥ	1
ⲛⲉⲛ ⲭⲣⲏⲙⲁ	ⲭⲣⲏⲙⲁ	1
ϩⲩⲡⲉⲣⲉⲧⲏⲥ ⲙ ⲡⲉ ⲭⲣⲓⲥⲧⲟⲥ	ϩⲩⲡⲉⲣⲉⲧⲏⲥ	1
ⲛ ⲇⲓⲕⲁⲓⲟⲛ	ⲇⲓⲕⲁⲓⲟⲛ	1
ϩⲉⲛ ⲕⲱⲧ ⲅⲁⲣ ⲧⲏⲣ ⲟⲩ	ⲕⲱⲧ	1
ⲛ ϭⲓϫ ⲛ ⲛⲓ ⲁⲧⲛⲁ	ϭⲓϫ	1
ⲧ ⲙⲁⲛⲓⲁ ⲉⲧ ϩⲟⲟⲩ · ⲧⲁⲓ ⲉⲧ ϣⲟⲟⲡ ϩⲛ ⲧ ⲥⲁⲣⲝ ⲉ ⲁ ϥ ⲧⲣ ⲁ ⲟⲩⲉ ⲉⲃⲟⲗ ⲙ ⲡ ⲙⲟⲩ ⲉⲧ ⲥⲁϣⲉ	ⲙⲁⲛⲓⲁ	1
ⲡ ⲁⲡⲟⲗⲗⲱⲛ ⲡ ⲛⲟϭ ⲛ ⲛⲟⲩⲧⲉ · ⲡⲁⲓ ⲉⲧ ϯ ⲛⲁ ⲛ ⲙ ⲡⲉ ϫⲣⲟ ϩⲙ ⲡ ⲡⲟⲗⲉⲙⲟⲥ	ⲁⲡⲟⲗⲗⲱⲛ	1
ⲛ ⲉⲛⲧ ⲁ ⲩ ⲁⲁ ⲩ ⲛ ⲥⲃⲱ	ⲛ	1
ⲛⲉⲩ ϩⲟⲉⲓⲧⲉ	ϩⲟⲉⲓⲧⲉ	1
ⲡ ϫⲱⲱⲣⲉ	ϫⲱⲱⲣⲉ	1
ⲡ ⲉⲧ ϫⲱ ⲙⲙⲟ ⲥ ϩⲛ ⲟⲩ ⲙⲛⲧⲣⲉϥⲧⲱϩ	ⲡ	1
ⲡⲉⲩ ⲉⲓⲱⲧ ⲍⲉⲃⲉⲇⲁⲓⲟⲥ	ⲍⲉⲃⲉⲇⲁⲓⲟⲥ	1
ⲙⲁⲣⲓⲁ	ⲙⲁⲣⲓⲁ	1
ⲙⲁⲧⲟⲓ	ⲙⲁⲧⲟⲓ	1
ⲡⲉⲕ ϣⲁϫⲉ	ⲡⲉⲕ	1
ⲟⲩ ⲙⲛⲧⲥⲁⲃⲉ	ⲙⲛⲧⲥⲁⲃⲉ	1
ⲡ ⲙⲁ ⲉⲧⲉ ⲙ ⲡⲉⲩ ϥⲛⲧ ⲛⲁ ⲙⲟⲩ ⲁⲛ	ⲙⲁ	1
ⲡ ϩⲙϫ	ϩⲙϫ	1
ⲡ ϩⲟϥ	ϩⲟϥ	1
ⲙⲉⲥⲧⲉ	ⲙⲉⲥⲧⲉ	1
ⲡ ϩⲁⲉ	ϩⲁⲉ	1
ⲡ ϩⲁⲏ	ϩⲁⲏ	1
ⲡ ϩⲙⲥ	ϩⲙⲥ	1
ⲡ ϭⲱⲃ	ϭⲱⲃ	1
ⲡ ⲕⲉ ϫⲓ	ϫⲓ	1
ⲉⲫⲉⲥⲟⲥ	ⲉⲫⲉⲥⲟⲥ	1
ⲗⲩⲡⲉⲓ ⲙⲙⲟ ϥ	ⲗⲩⲡⲉⲓ	1
ⲡ ⲉⲧ ϫⲓ ⲇⲉ ⲉϩⲟⲩⲛ ⲉ ⲡ ⲅⲉⲛⲟⲥ	ⲡ	1
ⲡ ⲉⲧ ⲕ ⲙⲉⲉⲩⲉ ⲉ ⲛⲁ ⲛ ⲕⲉ ϩⲏⲕⲉ ⲛϩⲏⲧ ϥ	ⲡ	1
ⲡ ⲙⲉⲉⲩⲉ ⲙ ⲡⲉ ⲭⲣⲓⲥⲧⲟⲥ	ⲙⲉⲉⲩⲉ	1
ⲡ ⲉⲧ ⲣⲟⲉⲓⲥ ⲙⲉⲛ ⲉⲣⲟ ϥ ⲉ ⲣϫⲓⲛϭⲟⲛⲥ	ⲡ	1
ⲡ ϣⲓ ⲛ ⲁⲡⲁ ⲁⲛⲧⲱⲛⲓⲟⲥ	ϣⲓ	1
ⲟⲩ ⲧⲱⲱⲃⲉ ⲛ ⲟⲙⲉ	ⲧⲱⲱⲃⲉ	1
ⲟⲩ ⲇⲓⲁⲑⲏⲕⲏ	ⲇⲓⲁⲑⲏⲕⲏ	1
ⲙⲛⲧⲛⲁ	ⲙⲛⲧⲛⲁ	1
ⲧⲃⲧ ⲥⲛⲁⲩ	ⲧⲃⲧ	1
ⲃⲏⲑⲥⲁⲓⲇⲁ	ⲃⲏⲑⲥⲁⲓⲇⲁ	1
ⲥⲟⲛ ⲙ ⲙⲟⲛⲁⲭⲟⲥ	ⲥⲟⲛ	1
ⲡ ⲉⲧ ϯ ⲙ ⲡ ⲟⲩⲁ ⲡ ⲟⲩⲁ · ⲕⲁⲧⲁ ⲛⲉϥ ϩⲃⲏⲩⲉ	ⲡ	1
ⲛ ⲛⲟϭ ⲛ ⲧ ⲅⲁⲗⲓⲗⲁⲓⲁ	ⲅⲁⲗⲓⲗⲁⲓⲁ	1
ⲡⲉ ⲑⲣⲟⲛⲟⲥ	ⲑⲣⲟⲛⲟⲥ	1
ⲛ ⲥⲁ ⲛ ⲇⲁⲗⲙⲁⲛⲟⲩⲑⲁ	ⲥⲁ	1
ⲡ ⲉⲧⲉ ⲙⲡ ⲕ ⲛⲁⲩ ⲉⲣⲟ ϥ ⲉⲛⲉϩ	ⲡ	1
ⲡⲉⲕ ϫⲁϫⲉ	ϫⲁϫⲉ	1
ⲛⲉϥ ϫⲁⲓⲟϩⲥ	ϫⲁⲓⲟϩⲥ	1
ⲧ ⲙⲛⲧⲙⲁⲓⲧⲟ ⲛ ϩⲟⲩⲟ	ⲙⲛⲧⲙⲁⲓⲧⲟ	1
ⲗⲁⲁⲩ ⲛ ⲁⲛⲁϣ	ⲗⲁⲁⲩ	1
ϩⲉⲛ ϩⲃⲏⲩⲉ ⲉ ⲛⲁⲛⲟⲩ ⲟⲩ	ϩⲃⲏⲩⲉ	1
ⲡⲉⲕ ϣⲓⲡⲉ	ϣⲓⲡⲉ	1
ⲟⲩ ϩⲱⲃ ⲙⲛ ⲡ ⲉⲧ ϩⲓⲧⲟⲩⲱ ϥ	ϩⲱⲃ	1
ⲧⲁϣⲉⲟⲉⲓϣ ϩⲛ ⲧ ⲇⲉⲕⲁⲡⲟⲗⲓⲥ ⲛ ⲛ ⲉⲛⲧ ⲁ ⲓⲏⲥⲟⲩⲥ ⲁⲁ ⲩ ⲛⲁ ϥ	ⲧⲁϣⲉⲟⲉⲓϣ	1
ⲧ ϣⲉⲉⲣⲉ ⲛ ⲃⲁⲥⲓⲗⲉⲓⲧⲏⲥ ⲡⲉ ⲥⲧⲣⲁⲧⲏⲗⲁⲧⲏⲥ	ϣⲉⲉⲣⲉ	1
ⲡⲉⲕ ϩⲟⲩⲛ	ϩⲟⲩⲛ	1
ⲛ ⲉⲧ ϣⲁⲁⲧ ⲉⲃⲟⲗ ϩⲛ ϩⲉⲛ ϩⲏⲩ	ⲛ	1
ⲧⲉ ⲩⲛⲟⲩ	ⲩⲛⲟⲩ	1
ⲡ ⲙⲉⲉⲩⲉ ⲙ ⲡ ⲙⲩⲥⲧⲏⲣⲓⲟⲛ · ⲙⲛ ⲧ ⲕⲟⲓⲛⲱⲛⲓⲁ ⲛⲧ ⲁ ⲥ ϣⲱⲡⲉ ⲉϩⲟⲩⲛ ⲉⲣⲱ ⲧⲛ	ⲙⲉⲉⲩⲉ	1
ⲉⲡⲁⲣⲭⲟⲥ	ⲉⲡⲁⲣⲭⲟⲥ	1
ⲛⲉⲕ ⲙⲏⲙⲟⲟⲩ ⲉⲧ ϩⲛ ϩⲉⲛ ϣⲟϣⲟⲩ	ⲙⲏⲙⲟⲟⲩ	1
ⲧⲉ ⲭⲱⲣⲁ	ⲭⲱⲣⲁ	1
ⲧⲟⲩ ϣⲉⲉⲣⲉ	ϣⲉⲉⲣⲉ	1
ⲛⲉ ⲡⲣⲉⲥⲃⲩⲧⲉⲣⲟⲥ ⲛ ⲧ ⲡⲟⲗⲓⲥ	ⲡⲣⲉⲥⲃⲩⲧⲉⲣⲟⲥ	1
ⲛ ⲉⲧ ⲧⲁⲙⲓⲏⲩ	ⲛ	1
ⲡ ϣⲟⲣⲡ ⲛ ⲉⲃⲟⲧ	ϣⲟⲣⲡ	1
ⲗⲁⲁⲩ ⲛ ⲕⲣⲟϥ	ⲗⲁⲁⲩ	1
ⲕⲟⲣⲃⲁⲛ . ⲉⲧⲉ ⲡⲁⲓ ⲡⲉ	ⲕⲟⲣⲃⲁⲛ	1
ⲟⲩⲁ ϩⲛ ⲛⲁⲓ	ⲟⲩⲁ	1
ⲡ ⲛⲟⲩⲧⲉ ⲛ ⲧ ⲡⲉ	ⲛⲟⲩⲧⲉ	1
ⲡⲉⲧⲛ ⲛⲟⲩⲧⲉ	ⲛⲟⲩⲧⲉ	1
ⲟⲩ ϫⲱ ⲙ ⲙⲟⲟⲩ	ϫⲱ	1
ⲥⲱⲥⲑⲉⲛⲏⲥ ⲡ ⲥⲟⲛ	ⲥⲱⲥⲑⲉⲛⲏⲥ	1
ⲛ ⲉⲧ ⲟⲩ ⲛⲁ ⲛϩⲏⲧ ⲟⲩ	ⲛ	1
ⲛ ϣⲁϫⲉ ⲛⲧ ⲁ ϥ ϫⲟⲟ ⲩ	ϣⲁϫⲉ	1
ⲛ ⲉⲧ ⲙⲟⲕϩ	ⲛ	1
ⲛ ⲉⲧ ⲥⲟϣϥ	ⲛ	1
ⲗⲁⲁⲩ ⲛ ⲣⲱⲙⲉ	ⲗⲁⲁⲩ	1
ⲗⲁⲁⲩ ⲛ ⲥⲁⲣⲝ	ⲗⲁⲁⲩ	1
ⲛ ⲉⲧⲉ ⲩⲛⲧⲁ ⲩ ⲥⲟⲩ	ⲛ	1
ⲡⲟⲩ ⲛⲟⲩⲧⲉ	ⲛⲟⲩⲧⲉ	1
ⲛⲟⲩϥⲉ	ⲛⲟⲩϥⲉ	1
ⲛ ϩⲩⲡⲟⲕⲣⲓⲧⲏⲥ	ϩⲩⲡⲟⲕⲣⲓⲧⲏⲥ	1
ⲟⲩ ⲡⲟⲣⲛⲟⲥ	ⲡⲟⲣⲛⲟⲥ	1
ⲛ ⲉⲛⲧ ⲁ ⲓ ⲥⲁϩⲟⲩ ⲛⲁ ⲕ	ⲛ	1
ⲛⲟⲉⲓⲕ	ⲛⲟⲉⲓⲕ	1
ⲛⲟⲩⲛⲉ	ⲛⲟⲩⲛⲉ	1
ⲛⲟⲩⲧⲉ	ⲛⲟⲩⲧⲉ	1
ⲡ ⲁⲧⲛⲟⲩⲧⲉ ⲛ ⲇⲓⲁⲃⲟⲗⲟⲥ	ⲁⲧⲛⲟⲩⲧⲉ	1
ϩⲉⲛ ϣⲧⲏⲛ ⲉ ⲩ ⲧⲁⲉⲓⲏⲩ	ϣⲧⲏⲛ	1
ⲡ ⲉⲧ ⲡⲁⲣⲁⲕⲁⲗⲉⲓ	ⲡ	1
ϩⲛⲁⲩ ⲛⲓⲙ · ⲛⲧⲉ ⲧⲉ ⲥϩⲓⲙⲉ ⲉⲧ ⲙⲙⲁⲩ	ϩⲛⲁⲩ	1
ⲛⲉⲩ ⲥⲩⲛⲁⲅⲱⲅⲏ	ⲥⲩⲛⲁⲅⲱⲅⲏ	1
ⲡⲉϥ ⲟⲩⲱϣ ⲧⲏⲣ ϥ	ⲟⲩⲱϣ	1
ⲛ ⲉⲛⲧ ⲁ ⲩ ϩⲩⲡⲟⲙⲓⲛⲉ ⲅⲁⲣ ϩⲙ ⲡⲁⲓ	ⲛ	1
ⲡ ⲙⲟⲩ ⲙ ⲙⲉϩⲥⲛⲁⲩ	ⲙⲟⲩ	1
ⲧ ⲥⲏϥⲉ ⲙ ⲡ ⲡⲟⲛⲏⲣⲟⲥ ⲡ ⲉⲛⲧ ⲁ ϥ ⲧⲁⲕⲟ ⲛ ⲧ ⲟⲓⲕⲟⲩⲙⲉⲛⲏ ⲧⲏⲣ ⲥ ϩⲛ ⲛⲉϥ ⲛⲟⲃⲉ ⲙⲛ ⲛⲉϥ ⲁⲛⲟⲙⲓⲁ	ⲥⲏϥⲉ	1
ⲡ ⲉⲧ ϣⲧⲁⲙ ⲛ ⲛⲉϥ ⲙⲁⲁϫⲉ ⲉ ⲧⲙ ⲥⲱⲧⲙ ⲉ ⲩ ϩⲏⲕⲉ	ⲡ	1
ⲡ ⲉⲧ ⲇⲓⲁⲕⲣⲓⲛⲉ ⲙⲙⲟ ⲕ	ⲡ	1
ⲧ ϭⲓⲛⲥⲱⲧⲙ	ϭⲓⲛⲥⲱⲧⲙ	1
ⲡⲉⲕ ⲇⲱⲣⲟⲛ	ⲇⲱⲣⲟⲛ	1
ⲟⲩ ⲥⲟⲛ ⲉⲣⲉ ⲟⲩ ⲥⲁⲛⲇⲁⲗⲓⲟⲛ ϩⲛ ⲛⲉⲕ ⲟⲩⲣⲏⲏⲧⲉ	ⲥⲟⲛ	1
ϩⲉⲛ ϣⲏⲛ	ϣⲏⲛ	1
ϩⲉⲛ ϩⲏⲩ	ϩⲏⲩ	1
ϩⲉⲛ ϩⲧⲟ	ϩⲧⲟ	1
ϩⲉⲛ ϭⲟⲗ	ϭⲟⲗ	1
ϩⲉⲛ ϯⲙⲉ	ϯⲙⲉ	1
ⲡ ⲉⲧⲉⲣⲉ ⲡ ⲉⲧ ⲥⲏϭ ⲛⲏϫ ϩⲓϫⲱ ϥ	ⲡ	1
ϩⲛⲁⲩ ⲛ ⲁⲧϣⲁⲩ	ϩⲛⲁⲩ	1
ⲡ ⲉⲟⲟⲩ ⲛ ⲛⲉⲕ ϫⲁϫⲉ	ⲉⲟⲟⲩ	1
ⲛ ⲉⲧⲉ ⲛⲟⲩⲃ	ⲛ	1
ⲛ ⲉⲧⲉ ⲛⲟⲩⲕ	ⲛ	1
ϩⲉⲛ ϣⲧⲏⲛ ⲙ ⲡⲉⲗϭⲉ ⲉ ⲩ ϩⲛ ⲛ ⲧⲟⲉⲓⲥ	ϣⲧⲏⲛ	1
ⲡ ⲣⲁⲛ ⲙ ⲡ ⲣⲱⲙⲉ	ⲣⲁⲛ	1
ⲡ ⲉⲧ ⲛⲏⲩ ⲉⲃⲟⲗ ϩⲛ ⲛⲉⲕ · [....]ⲥ	ⲡ	1
ⲣⲉϥⲛⲕⲟⲧⲕ ⲙⲛ ϩⲟⲟⲩⲧ	ⲣⲉϥⲛⲕⲟⲧⲕ	1
ⲛ ⲃⲁⲣⲃⲁⲣⲟⲥ	ⲃⲁⲣⲃⲁⲣⲟⲥ	1
ⲡ ⲣⲣⲟ ⲉⲧⲉ ⲙⲛ ⲕⲉ ⲟⲩⲁ ⲛⲃⲗⲗⲁ ϥ	ⲣⲣⲟ	1
ⲙⲏⲧ ⲛ ϣⲉ ⲛ ϩⲙϩⲁⲗ ⲛ ⲥϩⲓⲙⲉ · ⲉ ⲩ ϫⲓ ⲙⲁⲛⲓⲁⲕⲏⲥ ⲛ ⲛⲟⲩⲃ	ϩⲙϩⲁⲗ	1
ⲡ ⲣϩⲱⲃ ⲉ ⲁⲕⲁⲑⲁⲣⲥⲓⲁ ⲛⲓⲙ	ⲣϩⲱⲃ	1
ϩⲉⲛ ϩⲣⲟⲟⲩ ⲉ ⲩ ⲟϣ	ϩⲣⲟⲟⲩ	1
ⲧⲉ ⲯⲩⲭⲏ ⲛ ⲓⲱϩⲁⲛⲛⲏⲥ · ⲡ ⲉⲧⲉ ⲡⲱⲕ ⲡⲉ · ⲧⲁⲓ ⲛⲧ ⲁ ⲕ ⲁⲁ ⲥ ⲛ ⲙⲡϣⲁ ⲉ ⲧⲣⲉ ⲕ ⲥⲟⲩⲱⲛ ⲥ	ⲯⲩⲭⲏ	1
ⲩ ϩⲉⲃⲱⲱⲛ	ϩⲉⲃⲱⲱⲛ	1
ⲛ ⲉⲛⲧ ⲁ ⲡ ϫⲟⲉⲓⲥ ⲁⲁ ⲩ ⲛⲁ ⲕ	ⲛ	1
ϩⲉⲛ ⲉⲗⲁⲭⲓⲥⲧⲟⲛ ⲛ ⲁϥ	ⲉⲗⲁⲭⲓⲥⲧⲟⲛ	1
ⲟⲩⲏⲣ ⲙ ⲡⲉⲓⲣⲁⲥⲙⲟⲥ	ⲟⲩⲏⲣ	1
ⲧ ⲙⲏⲧⲉ ⲛ ⲛ ⲧⲟϣ ⲛ ⲧ ⲇⲉⲕⲁⲡⲟⲗⲓⲥ	ⲙⲏⲧⲉ	1
ⲡ ⲉⲛⲧ ⲁ ϥ ⲧⲛⲛⲟⲟⲩ ⲧ	ⲡ	1
ⲧⲉ ϩⲟⲩⲉⲓⲧⲉ	ϩⲟⲩⲉⲓⲧⲉ	1
ⲛ ⲃⲁⲗ	ⲃⲁⲗ	1
ⲟⲩ ϣⲟⲛⲧⲉ	ϣⲟⲛⲧⲉ	1
ⲛ ⲟⲩⲁ	ⲟⲩⲁ	1
ⲛ ⲧⲃⲧ	ⲧⲃⲧ	1
ⲛ ⲱⲛⲉ	ⲱⲛⲉ	1
ϯⲥⲃⲱ ⲛ ⲥⲟⲫⲓⲁ ⲛ ⲣⲱⲙⲉ	ϯⲥⲃⲱ	1
ⲡⲉ ⲡⲣⲟⲫⲏⲧⲏⲥ ⲙⲁⲗⲁⲭⲓⲁⲥ	ⲙⲁⲗⲁⲭⲓⲁⲥ	1
ⲛ ⲉⲛⲧ ⲁ ⲩ ϣⲱⲱⲧ ϩⲙ ⲡ ⲧⲟⲕ ⲙ ⲡⲉ ⲅⲣⲁⲙⲙⲁⲧⲉⲩⲥ ⲛ ⲛ ⲥⲉⲗⲓⲥ ⲙ ⲡ ϫⲱⲱⲙⲉ ⲛ ⲛ ϣⲁϫⲉ ⲛⲧ ⲁ ⲛⲉ ⲡⲣⲟⲫⲏⲧⲏⲥ ϫⲟⲟⲩ ⲥⲉ ⲛⲁ ⲩ ϩⲙ ⲡ ⲣⲁⲛ ⲙ ⲡ ⲛⲟⲩⲧⲉ	ⲛ	1
ⲛⲉ ⲛⲕⲁ ⲛ ⲛ ϩⲏⲕⲉ . ⲙⲛ ⲛⲉ ⲭⲏⲣⲁ ⲙⲛ ⲛ ⲟⲣⲫⲁⲛⲟⲥ	ⲛⲕⲁ	1
ⲧⲉⲛ ⲙⲁⲁⲩ	ⲙⲁⲁⲩ	1
ϩⲣⲁ ϥ	ϩⲣⲁ	1
ϩⲣⲁ ⲕ	ϩⲣⲁ	1
ⲥⲩⲛⲁⲝⲓⲥ	ⲥⲩⲛⲁⲝⲓⲥ	1
ⲙ ⲙⲉⲗⲟⲥ ⲙ ⲡⲉ ⲭⲣⲓⲥⲧⲟⲥ	ⲙⲉⲗⲟⲥ	1
ⲃⲁⲗ ⲥⲛⲁⲩ	ⲃⲁⲗ	1
ⲟⲩⲟⲛ ⲛⲓⲙ ⲉⲧ ⲉⲓⲣⲉ ⲛ ϩⲉⲛ ⲕⲣⲟϥ · ⲙ ⲙⲁⲁⲩ ⲛⲓⲙ ⲙ ⲡⲉ ⲙⲧⲟ ⲉⲃⲟⲗ ⲙ ⲡ ⲛⲟⲩⲧⲉ ϩⲛ ⲟⲩ ϩⲱⲡ · ⲏ ϩⲛ ⲟⲩ ⲟⲩⲱⲛϩ ⲉⲃⲟⲗ	ⲟⲩⲟⲛ	1
ⲡ ϫⲟⲉⲓⲥ ⲁⲩⲱ ⲡⲉϥ ⲭⲣⲓⲥⲧⲟⲥ ⲙⲛ ⲛⲉϥ ⲁⲅⲅⲉⲗⲟⲥ ⲉⲧ ⲟⲩⲁⲁⲃ ⲉⲧ ϥⲓ ϩⲁⲣⲟ ⲛ ϫⲓⲛ ⲧ ⲁⲣⲭⲏ ⲙ ⲡ ⲥⲱⲛⲧ ϣⲁϩⲣⲁⲓ ⲉ ⲡ ϩⲟⲟⲩ ⲛ ϩⲟⲟⲩ ⲁⲩⲱ ⲟⲛ ϣⲁ ⲉⲛⲉϩ	ϫⲟⲉⲓⲥ	1
ϯⲙⲟⲑⲉⲟⲥ	ϯⲙⲟⲑⲉⲟⲥ	1
ⲧ ⲁⲣⲭⲏ ⲙ ⲡ ⲉⲩⲁⲅⲅⲉⲗⲓⲟⲛ ⲛ ⲓⲏⲥⲟⲩⲥ ⲡⲉ ⲭⲣⲓⲥⲧⲟⲥ [ ⲡ ϣⲏⲣⲉ ⲙ ⲡ ⲛⲟⲩⲧⲉ ]	ⲁⲣⲭⲏ	1
ⲧⲟⲩ ⲙⲛⲧϫⲁⲥⲓϩⲏⲧ	ⲙⲛⲧϫⲁⲥⲓϩⲏⲧ	1
ⲧⲉⲭⲛⲏ ⲛⲓⲙ ⲙⲛ ⲉⲡⲏⲣⲉⲓⲁ ⲛⲓⲙ ⲛⲧⲉ ⲡ ϫⲁϫⲉ ⲉⲧ ϯ ⲟⲩⲃⲏ ⲛ ⲛ ⲟⲩⲟⲉⲓϣ ⲛⲓⲙ	ⲧⲉⲭⲛⲏ	1
ⲡ ⲙⲉⲉⲩⲉ ⲛ ⲛⲉϥ ⲉⲛⲧⲟⲗⲏ	ⲙⲉⲉⲩⲉ	1
ⲛⲉⲕ ⲙⲛⲧⲣⲉϥϫⲓⲛϭⲟⲛⲥ	ⲙⲛⲧⲣⲉϥϫⲓⲛϭⲟⲛⲥ	1
ⲡ ⲣⲉϥⲧⲁϣⲉⲟⲉⲓϣ	ⲣⲉϥⲧⲁϣⲉⲟⲉⲓϣ	1
ⲡⲁⲣⲁⲇⲟⲥⲓⲥ ⲛ ⲛ ⲣⲱⲙⲉ	ⲡⲁⲣⲁⲇⲟⲥⲓⲥ	1
ⲟⲩⲟⲛ ⲛⲓⲙ · ⲉⲧⲉ ⲙⲛ ϭⲟⲙ ⲙⲙⲟ ⲟⲩ	ⲟⲩⲟⲛ	1
ⲡⲉⲩ ⲧⲱϩ	ⲧⲱϩ	1
ⲡⲉⲩ ⲱⲃϣ	ⲱⲃϣ	1
ⲛ ϩⲏⲣⲱⲇⲓⲁⲛⲟⲥ	ϩⲏⲣⲱⲇⲓⲁⲛⲟⲥ	1
ⲡ ⲁⲡⲉ ⲛ ⲧ ⲥⲟⲟⲩϩⲥ	ⲁⲡⲉ	1
ⲧⲁ ϩⲙⲙⲉ	ϩⲙⲙⲉ	1
ⲛⲉϥ ⲃⲓⲣ	ⲃⲓⲣ	1
ⲧ ⲡⲁⲣϩⲏⲥⲓⲁ	ⲡⲁⲣϩⲏⲥⲓⲁ	1
ⲛⲉϥ ⲧⲛϩ	ⲧⲛϩ	1
ⲧ ⲟⲓⲕⲟⲩⲙⲉⲛⲏ ⲧⲏⲣ ⲥ	ⲟⲓⲕⲟⲩⲙⲉⲛⲏ	1
ϩⲉⲛ ϣⲏⲣⲉ ⲛ ⲓⲁⲕⲱⲃ	ϣⲏⲣⲉ	1
ⲟⲩ ϣⲏⲣⲉ ϣⲏⲙ ϫⲉ ⲃⲓⲕⲧⲱⲣ	ⲃⲓⲕⲧⲱⲣ	1
ⲛ ⲉⲧ ⲙⲏⲣ ⲉⲧⲉ ⲛ ⲉⲧ ⲙⲟⲕϩ ⲛⲉ	ⲛ	1
ϩⲉⲛ ϩⲱⲃ ⲛ ϭⲓϫ	ϩⲱⲃ	1
ⲟⲩ ⲛⲟϭ ⲉⲣⲟ ⲕ	ⲕ	1
ⲧ ⲉⲓⲣⲏⲛⲏ ⲉⲃⲟⲗ ϩⲓⲧⲙ ⲡ ⲛⲟⲩⲧⲉ ⲡⲉⲛ ⲉⲓⲱⲧ ⲙⲛ ⲡⲉⲛ ϫⲟⲉⲓⲥ ⲓⲏⲥⲟⲩⲥ ⲡⲉ ⲭⲣⲓⲥⲧⲟⲥ	ⲉⲓⲣⲏⲛⲏ	1
ⲡⲁ ⲡ ⲉⲧ ϩⲟⲟⲩ	ⲡⲁ	1
ⲛ ⲁⲅⲟⲣⲁ	ⲁⲅⲟⲣⲁ	1
ϩⲉⲛ ⲛⲟⲃⲉ ⲛⲁⲓ ⲉⲧ ⲕ ⲟ ⲛ ⲟⲩ ⲟⲉⲓⲉ ⲉⲣⲟ ⲟⲩ ⲛⲁ ϥ	ⲛⲟⲃⲉ	1
ⲡ ⲟⲩⲟⲉⲓⲛ ⲙ ⲡ ϣⲁϩ ⲛ ϩⲉⲛ ϩⲏⲃⲥ	ⲟⲩⲟⲉⲓⲛ	1
ⲧ ⲥⲱϣⲉ ⲛ ⲃⲟⲉⲥ ⲡⲉ ⲉⲃⲟⲗ ϩⲛ ⲧ ⲥⲩⲅⲅⲉⲛⲉⲓⲁ ⲛ ⲁⲃⲓⲙⲉⲗⲉⲭ	ⲥⲱϣⲉ	1
ⲟⲩⲟⲛ ⲛⲓⲙ ⲉⲧ ⲉⲓⲣⲉ ⲛ ϩⲉⲛ ⲕⲣⲟϥ ϩⲣⲁⲓ ϩⲛ ⲥⲩⲛⲁⲅⲱⲅⲏ ⲧⲏⲣ ⲟⲩ ⲙ ⲡ ϫⲟⲉⲓⲥ	ⲟⲩⲟⲛ	1
ⲛⲉⲧⲛ ϣⲟϫⲛⲉ ⲧⲏⲣ ⲟⲩ	ϣⲟϫⲛⲉ	1
ⲛ ⲉⲛⲧ ⲁ ⲕ ϫⲟⲟ ⲩ	ⲛ	1
ⲧ ⲙⲛⲧⲁⲅⲁⲑⲟⲥ ⲙ ⲡ ⲁⲅⲁⲑⲟⲥ ⲛ ⲣⲱⲙⲉ	ⲙⲛⲧⲁⲅⲁⲑⲟⲥ	1
ⲡⲉ ϣⲗⲏⲗ ⲙ ⲡ ⲉⲩⲁⲅⲅⲉⲗⲓⲟⲛ	ϣⲗⲏⲗ	1
ⲁⲑⲁⲛⲁⲥⲓⲟⲥ ⲁⲣⲭⲏⲉⲡⲓⲥⲕⲟⲡⲟⲩ	ⲁⲑⲁⲛⲁⲥⲓⲟⲥ	1
ⲟⲩⲛⲁⲙ	ⲟⲩⲛⲁⲙ	1
ⲛⲉϥ ⲙⲉⲅⲓⲥⲧⲁⲛⲟⲥ	ⲙⲉⲅⲓⲥⲧⲁⲛⲟⲥ	1
ⲛ ⲉⲧⲉ ⲙⲡⲉ ⲃⲁⲗ ⲛⲁⲩ ⲉⲣⲟ ⲟⲩ . ⲛ ⲉⲧⲉ ⲙⲡⲉ ⲙⲁⲁϫⲉ ⲥⲟⲧⲙ ⲟⲩ . ⲛ ⲉⲧⲉ ⲙⲡ ⲟⲩ ⲁⲗⲉ ⲉϩⲣⲁⲓ ⲉϫⲙ ⲡ ϩⲏⲧ ⲛ ⲣⲱⲙⲉ ⲛⲁⲓ ⲉⲛⲧ ⲁ ⲡ ⲛⲟⲩⲧⲉ ⲥⲃⲧⲱⲧ ⲟⲩ ⲛ ⲛ ⲉⲧ ⲙⲉ ⲙⲙⲟ ϥ	ⲛ	1
ⲛ ⲁⲛⲁⲩϣ	ⲁⲛⲁⲩϣ	1
ⲡ ⲣⲣⲟ ⲇⲉ ⲛ ⲧ ⲡⲉ	ⲣⲣⲟ	1
ⲧ ⲡⲁⲣⲣⲏⲥⲓⲁ ⲛ ϩⲩⲡⲟⲧⲁⲅⲏ ⲛⲓⲙ ϩⲓ ⲙⲛⲧⲥⲧⲙⲏⲧ ⲛⲓⲙ ϩⲓ ϩⲱⲃ ⲛⲓⲙ ⲛ ⲁⲅⲁⲑⲟⲛ	ⲡⲁⲣⲣⲏⲥⲓⲁ	1
ⲥⲟⲫⲓⲁ ⲛⲧⲉ ⲡ ⲛⲟⲩⲧⲉ	ⲥⲟⲫⲓⲁ	1
ⲧ ⲡⲟⲛⲏⲣⲓⲁ ⲙ ⲡ ⲣⲱⲙⲉ ⲛ ϫⲁϫⲉ	ⲡⲟⲛⲏⲣⲓⲁ	1
ϩⲉⲛ ⲕⲉⲛⲟⲇⲟⲝⲓⲁ	ⲕⲉⲛⲟⲇⲟⲝⲓⲁ	1
ϩⲉⲛ ϩⲩⲡⲁⲣⲭⲟⲛⲧⲁ	ϩⲩⲡⲁⲣⲭⲟⲛⲧⲁ	1
ⲡ ⲙⲁⲕⲁⲣⲓⲟⲥ ⲇⲉ ⲓⲱϩⲁⲛⲛⲏⲥ	ⲓⲱϩⲁⲛⲛⲏⲥ	1
ⲡ ⲉⲛⲧ ⲁ ⲩ ⲟⲩⲉϩⲥⲁϩⲛⲉ ⲙⲙⲟ ϥ ⲛⲁ ϥ ⲉⲃⲟⲗ ϩⲓⲧⲟⲟⲧ ϥ ⲙ ⲡ ⲡⲉⲧⲟⲩⲁⲁⲃ ⲡ ⲑⲉⲟⲗⲟⲅⲟⲥ ⲓⲱϩⲁⲛⲛⲏⲥ · ⲡ ϩⲙϩⲁⲗ ⲙ ⲡ ⲛⲟⲩⲧⲉ	ⲡ	1
ⲡⲉⲓ ⲥⲡⲩⲗⲁⲓⲟⲛ	ⲥⲡⲩⲗⲁⲓⲟⲛ	1
ⲡⲉⲗϭⲉ	ⲡⲉⲗϭⲉ	1
ⲡ ⲏⲓ ⲙ ⲡ ⲛⲟⲩⲧⲉ	ⲏⲓ	1
ⲡⲁⲑⲟⲥ	ⲡⲁⲑⲟⲥ	1
ⲟⲩ ⲫⲑⲟⲛⲟⲥ	ⲫⲑⲟⲛⲟⲥ	1
ⲛⲉⲧⲛ ϩⲓⲥⲉ	ϩⲓⲥⲉ	1
ⲩ ϩⲱⲃ	ϩⲱⲃ	1
ⲩ ⲕⲗⲟⲟⲗⲉ	ⲕⲗⲟⲟⲗⲉ	1
ⲩ ⲃⲁⲩⲕⲁⲗⲓⲟⲛ	ⲃⲁⲩⲕⲁⲗⲓⲟⲛ	1
ⲛⲉⲧⲛ ϭⲟⲟⲙ	ϭⲟⲟⲙ	1
ⲩ ⲥⲟⲛ ⲙ ⲙⲟⲛⲁⲭⲟⲥ ⲉ ϥ ⲛⲏⲩ ϣⲁⲣⲟ ⲓ ⲉ ϥ ⲱϣ ⲉ ⲛⲁⲩ ⲉ ⲡⲁ ϩⲟ	ⲥⲟⲛ	1
ⲡⲉⲗⲁⲕ	ⲡⲉⲗⲁⲕ	1
ⲡⲉⲧⲣⲁ	ⲡⲉⲧⲣⲁ	1
ⲓⲱϩⲁⲛⲛⲏⲥ ⲡ ⲉⲧ ϯⲃⲁⲡⲧⲓⲥⲙⲁ	ⲓⲱϩⲁⲛⲛⲏⲥ	1
ⲛ ⲉⲛⲧ ⲁ ⲩ ϯϭⲱⲛⲧ ⲙ ⲡ ⲛⲟⲩⲧⲉ ⲁⲩⲱ ⲁ ⲩ ⲗⲩⲡⲉⲓ ⲙ ⲡⲉϥ ⲡⲛⲉⲩⲙⲁ ⲉⲧ ⲟⲩⲁⲁⲃ	ⲛ	1
ⲡ ⲙⲁ ⲉⲧⲉⲣⲉ ⲛ ⲉⲥⲟⲟⲩ ⲛ ⲗⲁⲃⲁⲛ ⲛϩⲏⲧ ϥ	ⲙⲁ	1
ⲧ ⲟⲩⲓ ⲧ ⲟⲩⲓ ⲙⲙⲱ ⲧⲛ	ⲟⲩⲓ	1
ⲡ ⲧⲁⲉⲓⲟ ⲛ ⲛ ⲣⲱⲙⲉ	ⲧⲁⲉⲓⲟ	1
ⲧ ⲙⲛⲧⲁⲧⲛⲟⲩⲧⲉ ⲙ ⲡ ⲁⲧⲛⲟⲩⲧⲉ ⲛ ⲇⲓⲁⲃⲟⲗⲟⲥ	ⲙⲛⲧⲁⲧⲛⲟⲩⲧⲉ	1
ⲟⲩ ϣⲏⲣⲉ ⲡⲉ ⲉ ϥ ϩⲛ ⲙⲛⲧⲯⲓⲧⲉ ⲛ ⲣⲟⲙⲡⲉ · ⲉ ϥ ϣⲙϣⲉ ⲙ ⲡ ⲛⲟⲩⲧⲉ · ⲁⲩⲱ ⲉ ϥ ⲣϩⲟⲧⲉ ϩⲏⲧ ⲟⲩ ⲛ ⲛⲉϥ ⲉⲛⲧⲟⲗⲏ	ϣⲏⲣⲉ	1
ⲟⲩ ⲥϩⲓⲙⲉ ⲉⲣⲉ ⲡⲉ ⲥⲛⲟϥ ϣⲟⲩⲟ ⲙⲙⲟ ⲥ ⲉⲓⲥ ⲙⲛⲧⲥⲛⲟⲟⲩⲥ ⲛ ⲣⲟⲙⲡⲉ	ⲥϩⲓⲙⲉ	1
ⲓⲟⲩⲇⲁⲥ	ⲓⲟⲩⲇⲁⲥ	1
ⲁⲡⲁ ⲉⲫⲣⲁⲓⲙ	ⲉⲫⲣⲁⲓⲙ	1
ⲡⲟⲩ ϣⲁϫⲉ ⲛϩⲟⲩⲛ ϩⲙ ⲡⲉⲓ ⲙⲁ	ϣⲁϫⲉ	1
ϩⲁϩ ⲛ ⲧⲉⲗⲱⲛⲏⲥ	ⲧⲉⲗⲱⲛⲏⲥ	1
ⲟⲩ ϣⲙⲙⲱ	ϣⲙⲙⲱ	1
ⲡⲟⲣⲛⲏ	ⲡⲟⲣⲛⲏ	1
ⲩ ⲛⲟϭ ⲛ ⲱⲛⲉ	ⲱⲛⲉ	1
ϯϩⲁⲡ	ϯϩⲁⲡ	1
ⲟⲩ ϩⲏⲕⲉ	ϩⲏⲕⲉ	1
ⲟⲩ ϩⲙⲟⲧ	ϩⲙⲟⲧ	1
ⲟⲩ ϩⲟⲟⲩ	ϩⲟⲟⲩ	1
ⲟⲩ ϫⲛⲁϩ	ϫⲛⲁϩ	1
ⲡ ⲉⲧⲉ ⲩⲛ ϣϭⲟⲙ ⲙⲙⲟ ⲕ ⲉ ⲡⲁⲣⲁⲃⲁ ⲛϩⲏⲧ ϥ	ⲡ	1
ⲛⲁⲓ ⲉ ϩⲉⲛ ϩⲓⲥⲱⲛ ϩⲱ ⲟⲩ ⲛⲉ ⲛ ⲣⲣⲟ · ⲁⲩⲱ ⲉⲣⲉ ⲡ ⲣⲣⲟ ⲙⲉ ⲙⲙⲟ ⲟⲩ ⲉⲙⲁⲧⲉ	ⲛⲁⲓ	1
ⲟⲩ ϭⲗⲟϭ	ϭⲗⲟϭ	1
ⲧⲉ ⲭⲱⲣⲁ ⲧⲏⲣ ⲥ ⲛ ⲧ ⲓⲟⲩⲇⲁⲓⲁ	ⲭⲱⲣⲁ	1
ⲟⲩ ϯⲧⲱⲛ	ϯⲧⲱⲛ	1
ⲁⲡⲁ ϩⲱⲣⲥⲓⲏⲥⲓ	ϩⲱⲣⲥⲓⲏⲥⲓ	1
ⲡ ⲉⲧ ϣⲧⲟⲣⲧⲣ ⲙⲙⲟ ⲓ	ⲡ	1
ⲙ ⲡ ⲉⲧ ⲥ ⲛⲁ ⲟⲩⲟⲙ ϥ	ⲡ	1
ⲡⲉⲩ ⲉⲓⲱⲧ ⲉⲧ ⲟⲩⲏϩ ⲛϩⲏⲧ ⲟⲩ ⲓⲏⲥⲟⲩⲥ ⲉⲧ ⲟⲩ ⲕⲱ ⲛ ϩⲧⲏ ⲩ ⲉⲣⲟ ϥ	ⲓⲏⲥⲟⲩⲥ	1
ⲟⲩ ϣⲙⲙⲟ ⲉⲧⲃⲉ ⲡ ⲛⲟⲩⲧⲉ ⲉ ⲡⲉⲛ ⲥⲟⲛ ⲡⲉ	ϣⲙⲙⲟ	1
ⲡ ϣⲱϣ ⲉϩⲟⲩⲛ ⲉ ⲛⲉⲛ ⲕⲉ ϩⲙϩⲁⲗ	ϣⲱϣ	1
ⲡⲱⲗⲁϩ	ⲡⲱⲗⲁϩ	1
ϩⲟⲓⲛⲉ ⲇⲉ ⲛ ⲛⲉ ⲅⲣⲁⲙⲙⲁⲧⲉⲩⲥ	ϩⲟⲓⲛⲉ	1
ⲡ ϫⲱⲱⲙⲉ ⲛ ⲛ ϣⲁϫⲉ ⲛⲧ ⲁ ⲛⲉ ⲡⲣⲟⲫⲏⲧⲏⲥ ϫⲟⲟⲩ ⲥⲉ ⲛⲁ ⲩ ϩⲙ ⲡ ⲣⲁⲛ ⲙ ⲡ ⲛⲟⲩⲧⲉ	ϫⲱⲱⲙⲉ	1
ⲡ ⲉⲧ ⲛⲁ ⲥⲱⲱϥ ⲙ ⲡⲉ ⲣⲡⲉ ⲙ ⲡ ⲛⲟⲩⲧⲉ	ⲡ	1
ⲧ ϩⲏ ⲛ ⲛ ⲁⲓⲱⲛ	ϩⲏ	1
ⲓⲟⲩⲇⲁⲥ ⲡ ⲓⲥⲕⲁⲣⲓⲱⲧⲏⲥ ⲡ ⲉⲛⲧ ⲁ ϥ ⲡⲁⲣⲁⲇⲓⲇⲟⲩ ⲙⲙⲟ	ⲓⲟⲩⲇⲁⲥ	1
ⲛⲉ ⲥⲛⲏⲩ ⲧⲏⲣ ⲟⲩ	ⲥⲛⲏⲩ	1
ⲟⲩ ⲕⲱⲧ ⲛⲧⲉ ⲡ ⲛⲟⲩⲧⲉ	ⲕⲱⲧ	1
ⲡ ⲉⲧ ⲛⲁ ⲥⲱⲣⲙ ⲇⲉ ⲛ ⲧⲉϥ ⲯⲩⲭⲏ ⲉⲧⲃⲏⲏⲧ ⲙⲛ ⲡ ⲉⲩⲁⲅⲅⲉⲗⲓⲟⲛ	ⲡ	1
ⲡ ⲣⲣⲟ ⲍⲏⲛⲱⲛ	ⲍⲏⲛⲱⲛ	1
ϩⲉⲛ ⲇⲓⲕⲁⲓⲟⲛ	ⲇⲓⲕⲁⲓⲟⲛ	1
ⲡ ⲉⲛⲧ ⲁ ϥ ⲁⲙⲁϩⲧⲉ ⲛ ⲁⲃⲃⲁⲕⲟⲩⲙ ⲡⲉ ⲡⲣⲟⲫⲏⲧⲏⲥ ⲙ ⲡⲉ ⲟⲩⲟⲉⲓϣ	ⲡ	1
ⲡ ⲉⲧ ⲟⲩⲱϣ ⲉ ⲣⲛⲟϭ ⲛϩⲏⲧ ⲧⲏⲩⲧⲛ	ⲡ	1
ⲟⲩ ⲏⲓ , ⲏ ⲟⲩ ⲙⲁ ⲉ ⲙⲛ ⲭⲣⲏⲙⲁ ⲛϩⲏⲧ ϥ	ⲏⲓ	1
ϩⲉⲛ ⲉⲃⲟⲗ ⲛϩⲏⲧ ϥ ϩⲙ ⲡⲉ ⲭⲣⲓⲥⲧⲟⲥ ⲓⲏⲥⲟⲩⲥ ⲡⲁⲓ ⲉⲛⲧ ⲁ ϥ ϣⲱⲡⲉ ⲛⲁ ⲛ ⲛ ⲥⲟⲫⲓⲁ ⲉⲃⲟⲗ ϩⲓⲧⲙ ⲡ ⲛⲟⲩⲧⲉ ⲛ ⲇⲓⲕⲁⲓⲟⲥⲩⲛⲏ ⲁⲩⲱ ⲛ ⲧⲃⲃⲟ ⲁⲩⲱ ⲛ ⲥⲱⲧⲉ	ϥ	1
ⲡ ⲉⲛⲧ ⲁ ϥ ⲧⲥⲁⲃⲉ ⲉⲓⲁⲁⲧ ⲥ ⲉⲃⲟⲗ ⲉ ⲛⲉⲥ ϫⲁϫⲉ	ⲡ	1
ⲛ ⲁⲓⲱⲛ ⲧⲏⲣ ⲟⲩ ⲛ ⲁⲓⲱⲛ	ⲁⲓⲱⲛ	1
ⲡ ⲧⲟⲟⲩ ⲛ ⲁⲡⲁ ⲁⲛⲧⲱⲛⲓⲟⲥ	ⲧⲟⲟⲩ	1
ⲙⲁ ⲛⲓⲙ ⲛⲧⲁ ⲩ ⲛⲙⲙⲁ ⲛ	ⲙⲁ	1
ⲡⲉⲧⲛ ϣⲟⲩϣⲟⲩ	ϣⲟⲩϣⲟⲩ	1
ⲟⲩ ϫⲓⲛⲛϭⲟⲛⲥ	ϫⲓⲛⲛϭⲟⲛⲥ	1
ⲡ ⲟϩⲥ	ⲟϩⲥ	1
ⲛ ⲕⲉ ⲟⲩϩⲟⲟⲣ	ⲟⲩϩⲟⲟⲣ	1
ⲁⲃⲓⲙⲉⲗⲉⲭ ⲡ ϩⲁⲓ ⲛ ⲛⲟⲉⲙⲓⲛ	ⲁⲃⲓⲙⲉⲗⲉⲭ	1
ⲉⲓⲁⲁⲧ ⲥ	ⲉⲓⲁⲁⲧ	1
ⲛⲉ ϩⲃⲏⲩⲉ ⲛ ⲧ ⲇⲓⲕⲁⲓⲟⲥⲩⲛⲏ	ϩⲃⲏⲩⲉ	1
ⲙ ⲙⲁ ⲉⲧ ⲟⲩⲁⲁⲃ ⲙ ⲡ ⲛⲟⲩⲧⲉ	ⲙⲁ	1
ⲡ ⲕⲱϩ	ⲕⲱϩ	1
ⲡ ⲛⲟϭ	ⲛⲟϭ	1
ⲡ ⲟⲟϩ	ⲟⲟϩ	1
ⲡ ⲥⲱϣ	ⲥⲱϣ	1
ⲡ ⲟⲩⲁ	ⲟⲩⲁ	1
ⲡ ⲟⲩⲱ	ⲟⲩⲱ	1
ⲛ ⲥⲟⲟⲛⲉ ⲛ ⲛ ⲣⲉϥⲧⲱⲣⲡ	ⲥⲟⲟⲛⲉ	1
ⲛ ⲕⲟⲧⲥ ⲙ ⲡ ⲇⲓⲁⲃⲟⲗⲟⲥ	ⲕⲟⲧⲥ	1
ⲡ ⲡⲟⲛⲏⲣⲟⲥ ⲡ ⲉⲛⲧ ⲁ ϥ ⲧⲁⲕⲟ ⲛ ⲧ ⲟⲓⲕⲟⲩⲙⲉⲛⲏ ⲧⲏⲣ ⲥ ϩⲛ ⲛⲉϥ ⲛⲟⲃⲉ ⲙⲛ ⲛⲉϥ ⲁⲛⲟⲙⲓⲁ	ⲡⲟⲛⲏⲣⲟⲥ	1
ⲡ ⲉⲧⲉ ⲡⲱⲓ	ⲡ	1
ⲡ ⲉⲧ ⲛⲁ ⲟⲩⲱϣ ⲅⲁⲣ ⲉ ⲛⲁϩⲙ ⲧⲉϥ ⲯⲩⲭⲏ	ⲡ	1
ⲗⲁⲁⲩ ⲛ ⲛⲟϥⲣⲉ	ⲗⲁⲁⲩ	1
ⲛⲉⲩ ⲁⲓⲧⲏⲙⲁ ⲧⲏⲣ ⲟⲩ	ⲁⲓⲧⲏⲙⲁ	1
ⲡⲁ ⲑⲩⲥⲓⲁⲥⲧⲏⲣⲓⲟⲛ	ⲑⲩⲥⲓⲁⲥⲧⲏⲣⲓⲟⲛ	1
ⲟⲩⲟⲛ ⲛⲓⲙ ⲉⲧ ⲣϩⲟⲧⲉ ϩⲏⲧ ϥ ⲙ ⲡ ⲛⲟⲩⲧⲉ	ⲟⲩⲟⲛ	1
ⲡ ϩⲓⲥⲉ ⲧⲏⲣ ϥ ⲉⲛⲧ ⲁ ⲡⲉⲛ ⲉⲓⲱⲧ ϣⲟⲡ ϥ ⲛⲙⲙⲏ ⲧⲛ ⲧⲏⲣ ⲧⲛ	ϩⲓⲥⲉ	1
ⲟⲩ ⲉⲅⲕⲣⲁⲧⲓⲁ	ⲉⲅⲕⲣⲁⲧⲓⲁ	1
ⲛ ⲉⲧ ϩⲏⲡ ϩⲙ ⲡ ⲕⲁⲕⲉ	ⲛ	1
ⲥⲟⲩ ϫⲟⲩⲧⲥⲁϣϥⲉ ⲙ ⲡ ⲉⲃⲟⲧ ⲫⲁⲣⲙⲟⲩⲧⲉ	ϫⲟⲩⲧⲥⲁϣϥⲉ	1
ⲧ ⲙⲉⲣⲓⲥ	ⲙⲉⲣⲓⲥ	1
ϩⲏⲣⲱⲇⲓⲁⲥ ⲧ ϩⲓⲙⲉ ⲙ ⲫⲓⲗⲓⲡⲡⲟⲥ ⲡⲉϥ ⲥⲟⲛ	ϩⲏⲣⲱⲇⲓⲁⲥ	1
ⲡ ⲡⲉⲣⲓⲍⲱⲙⲁ	ⲡⲉⲣⲓⲍⲱⲙⲁ	1
ⲥⲁⲙⲓⲧ	ⲥⲁⲙⲓⲧ	1
ⲥⲁⲟⲩⲗ	ⲥⲁⲟⲩⲗ	1
ϩⲉⲛ ⲉⲫⲣⲁⲑⲁⲓⲟⲥ ⲉⲃⲟⲗ ϩⲛ ⲃⲏⲑⲗⲉⲉⲙ ⲙ ⲡ ⲕⲁϩ ⲛ ⲓⲟⲩⲇⲁ	ⲉⲫⲣⲁⲑⲁⲓⲟⲥ	1
ⲡ ⲙⲁ ⲛ ⲟⲩ ⲇⲓⲕⲁⲓⲟⲥⲩⲛⲏ	ⲙⲁ	1
ⲛⲉⲕ ⲉⲥⲑⲏⲧⲏⲣⲓⲟⲛ ⲉⲧ ϩⲓⲃⲟⲗ , ⲧ ϭⲓⲛⲛⲁⲩ , ⲧ ϭⲓⲛⲥⲱⲧⲙ , ⲧ ϭⲓⲛϣⲱⲗⲙ , ⲧ ϭⲓⲛϣⲁϫⲉ	ⲉⲥⲑⲏⲧⲏⲣⲓⲟⲛ	1
ⲟⲩ ⲙⲛⲧⲁⲡⲟⲧⲁⲕⲧⲓⲕⲟⲥ ⲉⲧ ϫⲏⲕ ⲉⲃⲟⲗ · ⲻ ⲛⲧⲉ ⲡⲉ ⲑⲃⲃⲓⲟ ⲛ ϩⲏⲧ	ⲙⲛⲧⲁⲡⲟⲧⲁⲕⲧⲓⲕⲟⲥ	1
ⲛⲉⲓ ⲕⲟⲩⲓ ⲉⲧ ⲥⲟⲃⲕ	ⲕⲟⲩⲓ	1
ⲟⲩ ϩⲛⲟ ⲛ ⲥⲟⲩⲟ	ϩⲛⲟ	1
ⲩ ⲇⲩⲛⲁⲧⲟⲥ ⲡⲉ ϩⲛ ⲧⲉϥ ϭⲟⲙ ⲉ ⲟⲩ ⲉⲃⲟⲗ ⲡⲉ ϩⲛ ⲧ ⲥⲩⲅⲅⲉⲛⲉⲓⲁ ⲛ ⲁⲃⲓⲙⲉⲗⲉⲭ ⲉ ⲡⲉϥ ⲣⲁⲛ ⲡⲉ ⲃⲟⲉⲥ	ⲃⲟⲉⲥ	1
ⲟⲩ ⲙⲁ ⲉ ⲙⲛ ⲭⲣⲏⲙⲁ ⲛϩⲏⲧ ϥ	ⲙⲁ	1
ⲑⲉⲁⲧⲣⲟⲛ ⲙ ⲡ ⲕⲟⲥⲙⲟⲥ	ⲑⲉⲁⲧⲣⲟⲛ	1
ⲧ ⲡⲟⲛⲏⲣⲓⲁ ⲙ ⲡ ⲡⲟⲛⲏⲣⲟⲥ ⲛ ⲣⲱⲙⲉ ⲉⲧ ⲏⲡ ⲉ ⲡ ⲣⲉϥⲣⲛⲟⲃⲉ ⲡ ⲥⲁⲧⲁⲛⲁⲥ	ⲡⲟⲛⲏⲣⲓⲁ	1
ⲡ ⲉⲃⲟⲧ ⲡⲁⲱⲛⲉ	ⲡⲁⲱⲛⲉ	1
ⲁⲡⲥ ⲛ ⲣⲱⲙⲉ	ⲁⲡⲥ	1
ⲛⲓ ⲙⲛⲧⲣⲉϥϯϭⲱⲛⲧ ⲙ ⲡ ⲛⲟⲩⲧⲉ	ⲙⲛⲧⲣⲉϥϯϭⲱⲛⲧ	1
ⲧ ⲁⲡⲉ ⲙ ⲡ ⲁⲡⲟⲗⲗⲱⲛ	ⲁⲡⲉ	1
ⲧⲉⲕ ⲁⲛⲁⲥⲧⲁⲥⲓⲥ ⲉⲧ ⲟⲩⲁⲁⲃ · ⲉⲃⲟⲗ ϩⲛ ⲛ ⲉⲧ ⲙⲟⲟⲩⲧ	ⲁⲛⲁⲥⲧⲁⲥⲓⲥ	1
ⲡⲉⲕ ⲉⲓⲱⲧ ⲕⲣⲟⲛⲟⲥ	ⲕⲣⲟⲛⲟⲥ	1
ⲛⲁ ⲉⲓⲟⲧⲉ	ⲉⲓⲟⲧⲉ	1
ⲟⲩ ϣⲁϫⲉ ⲉ ϫⲟⲟ ϥ	ϣⲁϫⲉ	1
ⲙⲁⲑⲁⲓⲟⲥ	ⲙⲁⲑⲁⲓⲟⲥ	1
ⲡ ⲁⲙⲁϩⲧⲉ	ⲁⲙⲁϩⲧⲉ	1
ⲟⲩ ϫⲓⲟⲩⲉ	ϫⲓⲟⲩⲉ	1
ⲟⲩ ⲃⲛⲛⲉ · ⲇⲉ ⲣⲏⲧ · ⲛⲥⲁ ⲃⲟⲗ ⲙ ⲡⲉϥ ⲙⲁ ⲛ ϣⲱⲡⲉ · ⲉ ⲥ ⲧⲁⲩⲟ ⲉⲃⲟⲗ ⲙ ⲙⲛⲧⲥⲛⲟⲟⲩⲥ ⲛ ⲗⲟⲟⲩ	ⲣⲏⲧ	1
ⲛⲉⲛ ⲟⲉⲓⲕ	ⲟⲉⲓⲕ	1
ⲥⲟⲫⲓⲁ	ⲥⲟⲫⲓⲁ	1
ⲟⲩ ⲥϩⲓⲙⲉ ⲉ ⲩⲛⲧ ⲥ ⲟⲩ ϣⲉⲉⲣⲉ ⲙⲙⲁⲩ ⲉⲣⲉ ⲟⲩ ⲡⲛⲉⲩⲙⲁ ⲛ ⲁⲕⲁⲑⲁⲣⲧⲟⲛ ⲛⲙⲙⲁ ⲥ	ⲥϩⲓⲙⲉ	1
ⲡ ⲟⲩϫⲁⲓ ⲙ ⲡⲁ ⲕⲣⲁⲧⲟⲥ	ⲟⲩϫⲁⲓ	1
ⲡ ⲉⲧ ⲉⲣⲉ ⲡ ⲇⲓⲁⲃⲟⲗⲟⲥ ⲛⲁ ϭⲙϭⲟⲙ ⲉⲣⲟ ϥ ϩⲛ ⲛⲉϥ ϩⲃⲏⲩⲉ ⲙ ⲙⲛⲧⲣⲉϥϩⲉⲧⲃⲯⲩⲭⲏ	ⲡ	1
ⲟⲩ ⲫⲗⲉⲕⲙⲁ	ⲫⲗⲉⲕⲙⲁ	1
ⲡ ⲗⲁⲟⲥ ⲧⲏⲣ ϥ	ⲗⲁⲟⲥ	1
ⲡⲉⲧⲛ ⲙⲁⲥⲉ	ⲙⲁⲥⲉ	1
ⲁⲡⲁ ⲡⲟⲓⲙⲏⲛ	ⲡⲟⲓⲙⲏⲛ	1
ⲡⲉⲧⲛ ⲧⲱϩⲙ	ⲧⲱϩⲙ	1
ⲡⲟⲛⲏⲣⲟⲛ ⲛⲓⲙ	ⲡⲟⲛⲏⲣⲟⲛ	1
ⲡ ⲉⲧ ⲓ ϣⲓⲛⲉ ⲛⲥⲱ ϥ	ⲡ	1
ⲡ ⲕⲟⲥⲙⲟⲥ ⲉⲧ ⲣ ⲡ ⲱⲃϣ ⲙ ⲡ ⲛⲟⲩⲧⲉ	ⲕⲟⲥⲙⲟⲥ	1
ⲡⲉ ⲙⲧⲟ ⲉⲃⲟⲗ ⲛ ⲛ ⲉⲧ ϩⲙⲟⲟⲥ	ⲙⲧⲟ	1
ⲡ ⲉⲧⲉ ⲛ ϥ ϯ ⲅⲁⲣ ⲁⲛ ⲛⲙⲙⲁ ⲛ	ⲡ	1
ⲧⲟⲉⲓⲥ ⲛ ϣⲁⲉⲓ	ⲧⲟⲉⲓⲥ	1
ⲛ ⲇⲱⲣⲉⲁ	ⲇⲱⲣⲉⲁ	1
ⲡ ⲟⲩⲱϣ ⲛ ⲛⲉⲕ ⲙⲁϩⲧ	ⲟⲩⲱϣ	1
ⲡⲉ ⲟⲩⲟⲉⲓϣ ⲛ ⲁⲡⲁ ⲡⲁⲙⲃⲱ ⲡⲉ ⲡⲣⲉⲥⲃⲩⲧⲉⲣⲟⲥ ⲛ ⲧ ⲉⲕⲕⲗⲏⲥⲓⲁ ⲛ ϣⲓⲏⲧ	ⲟⲩⲟⲉⲓϣ	1
ⲛ ϣⲏⲣⲉ ⲙ ⲡⲉ ϩⲣⲟⲩⲃⲃⲁⲉⲓ	ϣⲏⲣⲉ	1
ⲧⲉⲛⲟⲩ	ⲧⲉⲛⲟⲩ	1
ⲛⲉⲕ ϩⲟⲟⲩ ⲧⲏⲣ ⲟⲩ	ϩⲟⲟⲩ	1
ⲡ ⲑⲉⲟⲗⲟⲅⲟⲥ ⲓⲱϩⲁⲛⲛⲏⲥ	ⲓⲱϩⲁⲛⲛⲏⲥ	1
ⲛ ϭⲓϫ ⲙ ⲡ ⲛⲟⲩⲧⲉ	ϭⲓϫ	1
ⲛ ⲉⲛⲧ ⲁ ⲩ ⲙⲟⲩ	ⲛ	1
ⲛ ⲉⲛⲧ ⲁ ⲩ ⲛⲁⲩ	ⲛ	1
ⲧ ⲁⲣⲭⲏ · ⲛⲧ ⲁ ⲕ ⲉⲓ ⲉ ⲡⲉⲓ ⲙⲁ	ⲁⲣⲭⲏ	1
ⲙⲏⲧ ⲛ ⲣⲱⲙⲉ ⲉⲃⲟⲗ ϩⲛ ⲛⲉ ⲡⲣⲉⲥⲃⲩⲧⲉⲣⲟⲥ ⲛ ⲧ ⲡⲟⲗⲓⲥ	ⲣⲱⲙⲉ	1
ⲡ ⲉⲛⲧ ⲁ ⲗⲉⲅⲓⲱⲛ ϣⲱⲡⲉ ⲛⲙⲙⲁ ϥ	ϥ	1
ϩⲉⲛ ⲉϩⲟⲟⲩ	ⲉϩⲟⲟⲩ	1
ϩⲉⲗⲗⲏⲛ ⲛⲓⲙ	ϩⲉⲗⲗⲏⲛ	1
ⲟⲩ ⲑⲁⲃ ⲁⲛ ⲛ ⲁⲥ	ⲑⲁⲃ	1
ϩⲉⲛ ⲃⲓⲣ	ⲃⲓⲣ	1
ⲛⲓ ϣⲁϫⲉ ⲛ ϭⲟⲗ ϩⲓ ⲕⲟⲧⲥ	ϣⲁϫⲉ	1
ϩⲉⲛ ⲉⲓⲱ	ⲉⲓⲱ	1
ϥⲧⲟⲉ ⲛ ⲟⲩϣⲏ	ⲟⲩϣⲏ	1
ϩⲉⲛ ⲣⲁⲛ	ⲣⲁⲛ	1
ϩⲉⲛ ⲣⲓⲣ	ⲣⲓⲣ	1
ϩⲉⲛ ⲱⲛⲉ	ⲱⲛⲉ	1
ⲛ ⲉⲧⲉ ⲙ ⲙⲁⲥⲧⲓⲅⲝ ϩⲓⲱ ⲟⲩ	ⲛ	1
ⲡ ⲙⲁ ⲉⲧ ⲟⲩ ⲛⲁ ϭⲛⲭⲣⲏⲙⲁ ⲙⲙⲁⲩ	ⲙⲁ	1
ⲃⲁⲃⲉⲣⲱⲙⲉ ⲛ ⲣⲉϥⲕⲱⲧⲉ ⲛⲥⲁ ⲡ ⲡⲉⲧϩⲟⲟⲩ	ⲃⲁⲃⲉⲣⲱⲙⲉ	1
ⲧⲉⲥ ⲙⲛⲧⲁⲧⲥⲟⲟⲩⲛ	ⲙⲛⲧⲁⲧⲥⲟⲟⲩⲛ	1
ⲡ ⲉⲧ ⲛⲁ ⲥⲱⲱϥ ⲙ ⲡ ⲣⲡⲉ ⲙ ⲡ ⲛⲟⲩⲧⲉ	ⲡ	1
ⲟⲩⲉⲣⲏⲧⲉ ⲥⲛⲧⲉ	ⲟⲩⲉⲣⲏⲧⲉ	1
ⲛⲉ ϩⲓⲟⲟⲙⲉ	ϩⲓⲟⲟⲙⲉ	1
ⲛⲉ ϩⲓⲟⲟⲩⲉ	ϩⲓⲟⲟⲩⲉ	1
ⲡ ϩⲏⲧ ⲙ ⲡ ϫⲟⲉⲓⲥ	ϩⲏⲧ	1
ⲡ ⲉⲛⲧ ⲁ ϥ ⲧⲁⲁ ⲥ ⲛⲁ ϥ ⲙⲙⲓⲛⲙⲙⲟ ϥ ⲉ ⲥⲱⲃⲉ ⲛ ⲛⲉϥ ϫⲁϫⲉ	ⲡ	1
ⲡⲉ ⲥϣϥⲉ ⲛ ⲛⲟⲩⲧⲉ	ⲛⲟⲩⲧⲉ	1
ⲩ ⲛⲟϭ ⲛ ϩⲁⲧⲏⲩ	ϩⲁⲧⲏⲩ	1
ⲙⲏⲧ ⲛ ϣⲉ ⲛ ϭⲁⲙⲟⲩⲗ	ϭⲁⲙⲟⲩⲗ	1
ⲡⲁ ⲕⲏⲫⲁⲥ	ⲡⲁ	1
ⲡ ⲉⲧ ⲓ ϭⲱϣⲧ ⲉⲃⲟⲗ ϩⲏⲧ ϥ	ⲡ	1
ϩⲉⲛ ⲝⲉⲥⲧⲏⲥ	ⲝⲉⲥⲧⲏⲥ	1
ϩⲉⲛ ⲁⲕⲁⲑⲁⲣⲧⲟⲥ ⲙ ⲙⲁⲗⲁⲕⲟⲥ	ⲁⲕⲁⲑⲁⲣⲧⲟⲥ	1
ⲧ ⲕⲟⲓⲛⲱⲛⲓⲁ ⲙ ⲡⲉϥ ϣⲏⲣⲉ ⲓⲏⲥⲟⲩⲥ ⲡⲉ ⲭⲣⲓⲥⲧⲟⲥ ⲡⲉⲛ ϫⲟⲉⲓⲥ	ⲕⲟⲓⲛⲱⲛⲓⲁ	1
ⲛ ⲉⲧⲉ ⲛⲟⲩⲓ	ⲛⲟⲩⲓ	1
ⲧ ⲙⲛⲧⲁⲧⲛⲟⲃⲉ	ⲙⲛⲧⲁⲧⲛⲟⲃⲉ	1
ⲩ ⲥϩⲓⲙⲉ · ⲙ ⲙⲟⲛⲁⲭⲏ ⲉ ⲥ ⲛⲏⲩ ϣⲁⲣⲟ ⲓ ⲉ ⲁ ⲥ ⲧⲁⲥⲥⲉ ⲛⲁ ⲓ ⲛ ϩⲉⲛ ϩⲱⲃ ⲛ ϭⲓϫ	ⲥϩⲓⲙⲉ	1
ⲩ ϣⲟϣⲟⲩ	ϣⲟϣⲟⲩ	1
ⲛ ⲕⲉ ϩⲉⲑⲛⲟⲥ	ϩⲉⲑⲛⲟⲥ	1
ⲧ ⲉⲡⲓⲃⲟⲩⲗⲏ	ⲉⲡⲓⲃⲟⲩⲗⲏ	1
ⲧⲁ ⲟⲩⲣⲏⲏⲧⲉ	ⲟⲩⲣⲏⲏⲧⲉ	1
ⲧ ⲙⲉⲣⲓⲥ ⲛ ⲧ ⲥⲱϣⲉ ⲉⲧ ⲧⲁ ⲡⲉⲛ ⲥⲟⲛ ⲧⲉ ⲁⲃⲓⲙⲉⲗⲉⲭ ⲧⲁⲓ ⲉⲛⲧ ⲁ ⲩ ⲧⲁⲁ ⲥ ⲛ ⲛⲟⲉⲙⲓⲛ ⲧ ⲉⲛⲧ ⲁ ⲥ ⲕⲧⲟ ⲥ ⲉⲃⲟⲗ ϩⲛ ⲧ ⲥⲱϣⲉ ⲙ ⲙⲱⲁⲃ	ⲙⲉⲣⲓⲥ	1
ⲡⲓ ⲃⲁⲃⲉⲣⲱⲙⲉ ⲉⲧ ⲙⲙⲁⲩ ⲫⲁⲣⲁⲱ	ⲫⲁⲣⲁⲱ	1
ⲟⲩ ⲧⲃⲁ ⲛ ϣⲏⲣⲉ ⲉ ⲟⲩⲁ ⲡⲉ	ϣⲏⲣⲉ	1
ⲧⲉ ϩⲓⲏ ⲙ ⲡ ⲣⲣⲟ	ϩⲓⲏ	1
ⲡ ⲉⲧ ⲟⲩⲁⲁⲃ ⲙ ⲡ ⲛⲟⲩⲧⲉ	ⲡ	1
ⲡ ⲟⲣⲇⲓⲛⲟⲛ ⲇⲉ ⲛ ⲟⲩ ⲡⲣⲟⲧⲉⲕⲧⲱⲣ ⲧⲁϩⲟ ϥ · ⲉ ⲡⲉϥ ⲣⲁⲛ ⲡⲉ ⲃⲁⲥⲓⲗⲉⲓⲧⲏⲥ	ⲧⲁϩⲟ	1
ⲡⲁⲩⲗⲟⲥ ⲡ ϩⲙϩⲁⲗ ⲛ ⲓⲏⲥⲟⲩⲥ	ⲡⲁⲩⲗⲟⲥ	1
ⲧ ⲙⲛⲧⲁⲧⲥⲱⲧⲙ	ⲙⲛⲧⲁⲧⲥⲱⲧⲙ	1
ⲧ ⲙⲛⲧⲁⲧⲧⲁⲕⲟ	ⲙⲛⲧⲁⲧⲧⲁⲕⲟ	1
ⲛ ϭⲓϫ ⲙ ⲡⲓ ⲁⲛⲟⲙⲟⲥ ⲛⲁⲃⲟⲩⲭⲟⲇⲟⲛⲟⲥⲟⲣ	ϭⲓϫ	1
ⲛ ⲉⲧ ⲙⲟⲕϩ ϩⲛ ⲛⲉⲩ ϣⲱⲛⲉ	ⲛ	1
ⲛ ⲧⲛϩ ⲛ ⲛⲉⲩ ϩⲟⲉⲓⲧⲉ	ⲧⲛϩ	1
ⲛⲉ ⲯⲩⲭⲟⲟⲩⲉ ⲛ ⲛ ⲣⲱⲙⲉ	ⲯⲩⲭⲟⲟⲩⲉ	1
ⲧⲉⲛ ϭⲓⲛⲱⲛⲁϩ	ϭⲓⲛⲱⲛⲁϩ	1
ⲡⲉⲓ ϣⲓ	ϣⲓ	1
ⲛ ⲕⲟⲟⲩⲉ ⲉⲧ ⲛⲙⲙⲁ ϥ	ⲕⲟⲟⲩⲉ	1
ⲡ ϫⲟⲉⲓⲥ ⲓⲏⲥⲟⲩⲥ ⲡⲉ ⲭⲣⲓⲥⲧⲟⲥ ⲡⲁⲓ ⲛⲧ ⲁ ⲩ ⲟⲩⲉⲛϩ ⲡⲉϥ ⲣⲁⲛ ⲉⲃⲟⲗ ϩⲓⲧⲙ ⲡ ⲉⲓⲱⲧ	ⲓⲏⲥⲟⲩⲥ	1
ϩⲟⲧⲉ · ⲙ ⲡ ⲛⲟⲩⲧⲉ	ϩⲟⲧⲉ	1
ⲗⲁⲁⲩ ⲛ ⲗⲟⲓϭⲉ	ⲗⲁⲁⲩ	1
ⲙⲏⲧ ⲛ ϣⲉ ⲙ ⲙⲁⲥⲡⲟⲣⲕ	ⲙⲁⲥⲡⲟⲣⲕ	1
ⲡⲉⲛ ϣⲓ	ϣⲓ	1
ⲡⲉ ⲡⲣⲉⲥⲃⲩⲧⲉⲣⲟⲥ ⲛ ⲧ ⲉⲕⲕⲗⲏⲥⲓⲁ · ⲛ ϣⲓⲏⲧ	ⲡⲣⲉⲥⲃⲩⲧⲉⲣⲟⲥ	1
ϩⲉⲛ ⲥⲁⲃⲉ ϩⲙ ⲡⲉ ⲭⲣⲓⲥⲧⲟⲥ	ⲥⲁⲃⲉ	1
ⲡ ⲙⲁ ⲛ ⲛ ⲣⲱⲙⲉ ⲉⲧ ϣⲱⲛⲉ ⲙⲙⲁⲧⲉ ⲙⲛ ⲛ ϩⲗⲗⲟ ⲁ ⲩ ⲣϩⲁϩ ⲛ ⲣⲟⲙⲡⲉ	ⲙⲁ	1
ⲡⲉϥ ⲣⲡⲉ ⲉⲧⲉ ⲛⲧⲱⲧⲛ ⲡⲉ ⲙⲙⲓⲛⲙⲙⲱ ⲧⲛ	ⲣⲡⲉ	1
ⲡⲉⲓ ⲏⲓ	ⲏⲓ	1
ⲡ ⲉⲟⲟⲩ ⲙ ⲡ ⲉⲓⲱⲧ	ⲉⲟⲟⲩ	1
ⲧ ϩⲉ ⲛ ⲟⲩ ⲣⲱⲙⲉ ⲉϥϣⲁⲛ ⲛⲟⲩϫⲉ ⲙ ⲡⲉϥ ϭⲣⲟϭ ⲉϩⲣⲁⲓ ⲉ ⲡⲉϥ ⲕⲁϩ	ϩⲉ	1
ⲡⲉⲕ ⲙⲁ	ⲙⲁ	1
ⲡⲉⲕ ⲣⲟ	ⲣⲟ	1
ⲟⲩ ⲟⲩⲱⲛϩ ⲉⲃⲟⲗ ⲙ ⲡⲛⲉⲩⲙⲁ ϩⲓ ϭⲟⲙ	ⲟⲩⲱⲛϩ	1
ⲧⲉϥ ⲣⲓ	ⲣⲓ	1
ⲧⲉⲕ ϣⲟⲩⲱⲃⲉ	ϣⲟⲩⲱⲃⲉ	1
ⲛⲉⲕ ⲡ ⲉⲧ ⲟⲩⲁⲁⲃ ⲙ ⲡⲣⲟⲫⲏⲧⲏⲥ	ⲡ	1
ⲡⲉⲥ ϩⲟ	ϩⲟ	1
ⲧ ⲛⲏⲥⲧⲓⲁ	ⲛⲏⲥⲧⲓⲁ	1
ϫⲱ ⲕ	ϫⲱ	1
ⲡ ϩⲏⲃⲥ ⲛ ⲛⲁ ⲟⲩⲉⲣⲏⲧⲉ	ϩⲏⲃⲥ	1
ⲁⲕⲁⲑⲁⲣⲥⲓⲁ ⲛⲓⲙ	ⲁⲕⲁⲑⲁⲣⲥⲓⲁ	1
ⲡⲉⲥ ⲏⲓ	ⲏⲓ	1
ϩⲩⲡⲟⲕⲣⲓⲥⲓⲥ	ϩⲩⲡⲟⲕⲣⲓⲥⲓⲥ	1
ϩⲙϩⲁⲗ ⲙ ⲡ ϫⲟⲉⲓⲥ ⲡⲉϥ ⲭⲣⲓⲥⲧⲟⲥ ⲓⲏⲥⲟⲩⲥ	ϩⲙϩⲁⲗ	1
ⲟⲩ ⲙⲁⲁⲩ ⲛ ⲟⲩⲱⲧ ⲉⲧⲉ ⲧ ϩⲓⲉⲣⲟⲩⲥⲁⲗⲏⲙ ⲛ ⲧ ⲡⲉ ⲧⲉ	ⲙⲁⲁⲩ	1
ⲧⲉⲕ ⲟⲩⲉⲣⲏⲧⲉ	ⲟⲩⲉⲣⲏⲧⲉ	1
ⲡ ⲧⲏ ⲙ ⲡ ⲱϩⲥ ϣⲱⲡⲉ	ϣⲱⲡⲉ	1
ⲡⲉ ⲥⲕⲉⲩⲟⲥ ⲉⲧ ⲕ ⲛⲁ ϩⲟⲟⲩⲧⲛ ⲉⲣⲟ ϥ	ⲥⲕⲉⲩⲟⲥ	1
ϩⲙⲉ ⲇⲉ ⲛ ϣⲉ	ⲇⲉ	1
ϩⲉⲛ ⲙⲉ	ⲙⲉ	1
ⲟⲩ ⲕⲣⲁⲥⲓⲥ · ⲉ ⲥ ϣⲏϣ	ⲕⲣⲁⲥⲓⲥ	1
ⲛⲓ ⲡⲁⲣⲑⲉⲛⲟⲥ ⲛ ⲥⲟϭ , ⲉⲧⲉ ⲙⲛ ⲛⲉϩ ϩⲛ ⲛⲉⲩ ⲁⲅⲅⲓⲟⲛ	ⲡⲁⲣⲑⲉⲛⲟⲥ	1
ⲛϭⲓ ⲡ ⲉⲧ ⲛⲁ ϫⲱϩⲙ ⲙ ⲡⲉϥ ⲥⲱⲙⲁ ⲕⲁⲧⲁ ⲗⲁⲁⲩ ⲛ ⲥⲙⲟⲧ	ⲡ	1
ⲟⲩ ⲥⲟⲫⲓⲁ ⲁⲛ ⲛ ϣⲁϫⲉ	ⲥⲟⲫⲓⲁ	1
ⲙⲁⲗⲁⲕⲟⲥ	ⲙⲁⲗⲁⲕⲟⲥ	1
ϩⲉⲛ ⲙⲟⲩⲛⲅ ⲛ ϭⲓϫ ⲉ ⲩ ϣⲟⲩⲉⲓⲧ	ⲙⲟⲩⲛⲅ	1
ⲩ ⲥⲙⲏ	ⲥⲙⲏ	1
ⲛ ⲟⲓⲕⲟⲛⲟⲙⲟⲥ ⲛ ⲙ ⲙⲩⲥⲧⲏⲣⲓⲟⲛ ⲙ ⲡ ⲛⲟⲩⲧⲉ	ⲟⲓⲕⲟⲛⲟⲙⲟⲥ	1
ⲛⲉ ⲭⲣⲉⲓⲥⲧⲓⲁⲛⲟⲥ	ⲭⲣⲉⲓⲥⲧⲓⲁⲛⲟⲥ	1
ⲡ ⲕⲟⲙⲉⲥ ⲁⲗⲉⲝⲁⲛⲇⲣⲟⲥ	ⲁⲗⲉⲝⲁⲛⲇⲣⲟⲥ	1
ⲡ ⲧⲟⲟⲩ ⲉⲧ ⲕ ⲛϩⲏⲧ ϥ	ⲧⲟⲟⲩ	1
ⲡⲉ ⲕⲗⲟⲙ ⲙ ⲡ ⲁⲡⲟⲗⲗⲱⲛ	ⲕⲗⲟⲙ	1
ⲕⲟⲩⲓ ϩⲙ ⲡⲉ ⲭⲣⲓⲥⲧⲟⲥ	ⲕⲟⲩⲓ	1
ϩⲁϩ ⲙ ⲡⲛⲉⲩⲙⲁ	ⲡⲛⲉⲩⲙⲁ	1
ϣⲉⲗⲉⲉⲧ	ϣⲉⲗⲉⲉⲧ	1
ⲛ ⲥⲩⲙⲙⲉⲧⲟⲭⲟⲥ ⲙ ⲡⲉ ⲭⲣⲓⲥⲧⲟⲥ ⲓⲏⲥⲟⲩⲥ ⲡⲉⲛ ϫⲟⲉⲓⲥ	ⲥⲩⲙⲙⲉⲧⲟⲭⲟⲥ	1
ⲡ ϣⲓⲡⲉ ⲙ ⲡⲉ ϩⲟⲟⲩ ⲛ ⲧⲉ ⲕⲣⲓⲥⲓⲥ	ϣⲓⲡⲉ	1
ⲛⲉ ⲕⲣⲓⲧⲏⲥ	ⲕⲣⲓⲧⲏⲥ	1
ϣⲁⲁⲣ	ϣⲁⲁⲣ	1
ϣⲓⲡⲉ	ϣⲓⲡⲉ	1
ϣⲗⲏⲗ	ϣⲗⲏⲗ	1
ϣⲙⲙⲟ	ϣⲙⲙⲟ	1
ϣⲟⲟⲩ	ϣⲟⲟⲩ	1
ⲛⲉϥ ⲥⲩⲛⲁⲝⲓⲥ	ⲥⲩⲛⲁⲝⲓⲥ	1
ⲛⲉⲓ ⲥⲁϩⲟⲩ ⲧⲏⲣ ⲟⲩ	ⲥⲁϩⲟⲩ	1
ϣⲱⲣⲡ	ϣⲱⲣⲡ	1
ⲡ ϩⲙϩⲁⲗ ⲡ ⲉⲧ ϩⲓϫⲛ ⲛ ⲉⲧ ⲱϩⲥ	ϩⲙϩⲁⲗ	1
ⲛ ⲉⲓⲇⲱⲗⲟⲛ	ⲉⲓⲇⲱⲗⲟⲛ	1
ⲡⲁ ⲙⲉⲣⲓⲧ ⲛ ϣⲏⲣⲉ ϩⲙ ⲡ ϫⲟⲉⲓⲥ	ⲙⲉⲣⲓⲧ	1
ⲛⲉⲕ ϣⲁϫⲉ ⲉⲧⲉ ⲕ ϫⲱ ⲙⲙⲟ ⲟⲩ	ϣⲁϫⲉ	1
ⲧⲉⲓ ⲙⲛⲧⲁⲧⲥⲱⲧⲙ	ⲙⲛⲧⲁⲧⲥⲱⲧⲙ	1
ϩⲱⲧⲃ	ϩⲱⲧⲃ	1
ⲧⲉ ⲧⲣⲁⲡⲉⲍⲁ	ⲧⲣⲁⲡⲉⲍⲁ	1
ϭⲗⲟϭ	ϭⲗⲟϭ	1
ⲧ ⲡⲉⲧⲣⲁ	ⲡⲉⲧⲣⲁ	1
ⲡ ⲉⲛⲧ ⲁ ϥ ⲉⲓⲣⲉ ⲙ ⲡⲉⲓ ϩⲱⲃ	ⲡ	1
ϯⲥⲙⲏ	ϯⲥⲙⲏ	1
ⲛ ⲁⲣⲭⲓⲉⲣⲉⲩⲥ	ⲁⲣⲭⲓⲉⲣⲉⲩⲥ	1
ⲡ ⲉⲧ ⲛⲁ ⲥⲕⲁⲛⲇⲁⲗⲓⲍⲉ ⲛ ⲟⲩⲁ ⲛ ⲛⲁⲓ ⲕⲟⲩⲓ ⲉⲧ ⲡⲓⲥⲧⲉⲩⲉ ⲉⲣⲟ ⲓ	ⲡ	1
ⲟⲩ ⲥⲟⲡ ⲛ ⲟⲩⲱⲧ	ⲥⲟⲡ	1
ⲧ ⲡⲟⲣϣⲥ	ⲡⲟⲣϣⲥ	1
ⲟⲩⲁ ⲛ ⲛⲁⲓ ⲕⲟⲩⲓ ⲉⲧ ⲡⲓⲥⲧⲉⲩⲉ ⲉⲣⲟ ⲓ	ⲟⲩⲁ	1
ⲙⲏⲧ ⲛ ϩⲙϩⲁⲗ ⲛ ϩⲟⲟⲩⲧ	ϩⲙϩⲁⲗ	1
ⲟⲩ ⲇⲓⲕⲁⲓⲟⲛ	ⲇⲓⲕⲁⲓⲟⲛ	1
ⲙⲉϣⲉ ⲛⲓⲙ ⲁⲛⲁⲭⲱⲣⲏⲧⲏⲥ	ⲙⲉϣⲉ	1
ⲡ ⲉⲧⲉ ϥ ⲛⲁ ϫⲟⲟ ϥ ⲛⲁ ⲕ	ⲡ	1
ⲛⲉϥ ⲥⲡⲟⲧⲟⲩ	ⲥⲡⲟⲧⲟⲩ	1
ⲛ ⲉⲛⲧ ⲁ ⲥ ⲥⲉⲓ ⲛϩⲏⲧ ⲟⲩ	ⲛ	1
ⲧ ⲡⲟⲣⲛⲏ	ⲡⲟⲣⲛⲏ	1
ⲟⲩⲁ ⲇⲉ ⲉⲃⲟⲗ ⲛϩⲏⲧ ⲛ	ⲟⲩⲁ	1
ⲛⲉ ⲣⲱⲙⲉ	ⲣⲱⲙⲉ	1
ⲛⲉ ⲥⲟⲩⲟ	ⲥⲟⲩⲟ	1
ⲡⲉⲩ ϣⲱⲱⲧ	ϣⲱⲱⲧ	1
ⲛ ⲕⲟⲗⲁⲥⲓⲥ	ⲕⲟⲗⲁⲥⲓⲥ	1
ⲟⲩ ⲙⲁ ⲛ ⲙⲧⲟⲛ	ⲙⲁ	1
ⲧ ⲥⲏϥⲉ ⲡⲉ ⲙ ⲡⲉⲕ ϣⲟⲩϣⲟⲩ	ⲥⲏϥⲉ	1
ⲡⲉⲩ ϩⲓⲥⲉ	ϩⲓⲥⲉ	1
ⲡⲉⲩ ϩⲟⲩⲟ	ϩⲟⲩⲟ	1
ⲡⲉⲩ ϩⲧⲟⲣ	ϩⲧⲟⲣ	1
ⲟⲩ ⲛⲟϭ ⲛ ϣⲱⲛⲉ	ϣⲱⲛⲉ	1
ⲟⲩ ⲛⲟϭ ⲛ ϩⲟⲧⲉ	ϩⲟⲧⲉ	1
ⲡ ⲟⲩⲟⲉⲓⲛ ⲛ ϩⲉⲛ ϩⲏⲃⲥ	ⲟⲩⲟⲉⲓⲛ	1
ⲛ ⲣⲉϥⲥⲱⲧⲙ ⲙⲙⲁⲧⲉ ⲁⲛ ⲙⲙⲟ ⲛ	ⲣⲉϥⲥⲱⲧⲙ	1
ⲧⲉ ⲭⲁⲣⲓⲥ ⲛⲏ ⲧⲛ ⲙⲛ ⲧ ⲉⲓⲣⲏⲛⲏ ⲉⲃⲟⲗ ϩⲓⲧⲙ ⲡ ⲛⲟⲩⲧⲉ ⲡⲉⲛ ⲉⲓⲱⲧ ⲙⲛ ⲡⲉⲛ ϫⲟⲉⲓⲥ ⲓⲏⲥⲟⲩⲥ ⲡⲉ ⲭⲣⲓⲥⲧⲟⲥ	ⲭⲁⲣⲓⲥ	1
ⲟⲩ ⲁⲙⲉⲗⲓⲁ	ⲁⲙⲉⲗⲓⲁ	1
ϣⲙⲛⲧϣⲉⲥⲉⲧⲏ ⲛ ⲥⲟⲡ	ⲥⲟⲡ	1
ⲛⲉϥ ϩⲛⲁⲟⲩ	ϩⲛⲁⲟⲩ	1
ⲧ ⲉⲛⲧ ⲁ ⲥ ⲣ ⲡⲁⲓ	ⲧ	1
ϥⲧⲟⲟⲩ ⲛ ϩⲟⲟⲩ	ϩⲟⲟⲩ	1
ⲟⲩⲁ ⲛ ⲁⲣⲭⲓⲥⲩⲛⲁⲅⲱⲅⲟⲥ ⲉ ⲡⲉϥ ⲣⲁⲛ ⲡⲉ ⲓⲁⲉⲓⲣⲟⲥ	ⲟⲩⲁ	1
ⲛ ⲉⲧ ϩⲏⲡ ⲛⲧⲉ ⲡ ⲛⲟⲩⲧⲉ	ⲛ	1
ⲛⲉϥ ⲥⲃⲟⲟⲩⲉ ⲛ ⲱⲛϩ	ⲥⲃⲟⲟⲩⲉ	1
ϩⲁϩ ⲙ ⲙⲉⲧⲁⲛⲟⲓⲁ	ⲙⲉⲧⲁⲛⲟⲓⲁ	1
ϩⲱⲃ ⲛⲓⲙ ⲛ ⲁⲅⲁⲑⲟⲛ	ϩⲱⲃ	1
ⲛ ϣⲉⲉⲣⲉ ϣⲏⲙ ⲛ ⲃⲟⲉⲥ	ϣⲉⲉⲣⲉ	1
ⲛⲟⲩ ⲃⲁⲗ	ⲃⲁⲗ	1
ⲩ ⲛⲟⲃⲉ	ⲛⲟⲃⲉ	1
ⲛ ϫⲟⲓ ⲛ ⲃⲣⲣⲉ ⲛⲧ ⲁ ⲧⲉⲧⲛ ⲙⲟⲛⲕ ⲟⲩ	ϫⲟⲓ	1
ⲓⲏⲥⲟⲩⲥ ⲡⲉ ⲭⲣⲓⲥⲧⲟⲥ [ ⲡ ϣⲏⲣⲉ ⲙ ⲡ ⲛⲟⲩⲧⲉ ]	ⲓⲏⲥⲟⲩⲥ	1
ⲥⲟⲫⲓⲁ ⲛ ϣⲁϫⲉ	ⲥⲟⲫⲓⲁ	1
ⲛ ⲕⲱⲧ · ⲛ ⲧ ⲙⲛⲧⲙⲟⲛⲁⲭⲟⲥ	ⲕⲱⲧ	1
ⲧⲉⲕ ϣⲉⲉⲣⲉ	ϣⲉⲉⲣⲉ	1
ⲛ ⲕⲟⲟⲩⲉ ⲇⲉ ⲧⲏⲣ ⲟⲩ ⲉⲧ ⲉϣϣⲉ ⲉ ⲥⲁϩ ⲟⲩ ⲉϩⲣⲁⲓ ⲉ ⲧⲉⲓ ⲉⲡⲓⲥⲧⲟⲗⲏ	ⲕⲟⲟⲩⲉ	1
ⲩ ⲥⲛⲧⲉ	ⲥⲛⲧⲉ	1
ⲛⲁⲓ ⲇⲉ ⲛⲁ ⲥⲛⲏⲩ ⲛⲧ ⲁ ⲓ ϫⲓⲧ ⲟⲩ ⲛ ⲥⲙⲟⲧ ⲉϩⲣⲁⲓ ⲉϫⲱ ⲓ ⲙⲛ ⲁⲡⲟⲗⲗⲱ ⲉⲧⲃⲉ ⲧⲏⲩⲧⲛ	ⲛⲁⲓ	1
ⲩ ⲧⲟⲟⲩ	ⲧⲟⲟⲩ	1
ⲩ ⲧⲱⲃⲥ	ⲧⲱⲃⲥ	1
ⲩ ⲧⲱⲣⲡ	ⲧⲱⲣⲡ	1
ϩⲉⲛ ⲉⲥⲟⲟⲩ ⲉ ⲙⲙⲛⲧ ⲟⲩ ϣⲱⲥ	ⲉⲥⲟⲟⲩ	1
ⲟⲩ ϭⲣⲟⲟⲙⲡⲉ	ϭⲣⲟⲟⲙⲡⲉ	1
ⲟⲩ ⲁⲛⲁⲅⲕⲏ	ⲁⲛⲁⲅⲕⲏ	1
ϩⲉⲛ ⲙⲁ ⲛ ϫⲁⲓⲉ	ⲙⲁ	1
ⲅⲣⲁⲙⲙⲁⲧⲉⲩⲥ	ⲅⲣⲁⲙⲙⲁⲧⲉⲩⲥ	1
ⲛ ⲃⲟⲏⲑⲟⲥ	ⲃⲟⲏⲑⲟⲥ	1
ⲡⲉⲕ ⲛⲟⲩⲧⲉ	ⲛⲟⲩⲧⲉ	1
ⲡ ⲙⲧⲟⲛ ⲛ ϣⲁ ⲉⲛⲉϩ	ⲙⲧⲟⲛ	1
ⲧⲣⲓⲁⲥ ⲉⲧ ⲥⲙⲁⲙⲁⲁⲧ	ⲧⲣⲓⲁⲥ	1
ⲟⲩⲟⲓ ⲇⲉ ⲛ ⲛ ϣⲏⲣⲉ ⲙ ⲡ ⲕⲁⲕⲉ ⲉⲧⲉ ⲛ ⲉⲧ ⲙⲟⲟϣⲉ ⲛⲉ ϩⲛ ⲙⲛⲧⲁⲧⲥⲱⲧⲙ ⲛⲓⲙ ϩⲓ ⲙⲛⲧⲁⲧⲥⲃⲱ ⲛⲓⲙ	ⲟⲩⲟⲓ	1
ⲛ ⲧⲟϣ ⲛ ⲧⲩⲣⲟⲥ ⲛⲙ ⲥⲓⲇⲱⲛ	ⲧⲟϣ	1
ⲡⲁⲓ ⲟⲛ ⲉⲛⲧ ⲁ ⲩ ϫⲟⲟ ⲥ	ⲡⲁⲓ	1
ⲟⲩ ϩⲙϩⲁⲗ ⲛ ⲁⲧϣⲁⲩ	ϩⲙϩⲁⲗ	1
ⲇⲱⲣⲟⲛ ⲅⲁⲣ ⲉϩⲟⲩⲛ ⲙ ⲡ ⲛⲟⲩⲧⲉ ⲉⲃⲟⲗ ϩⲛ ⲟⲩ ϫⲓⲛⲛϭⲟⲛⲥ ⲙⲛ ⲟⲩ ⲧⲱⲣⲡ	ⲇⲱⲣⲟⲛ	1
ⲛⲟϭ ⲉⲣⲟ ⲕ	ⲕ	1
ⲩ ⲣⲱⲙⲉ ⲛⲧⲉ ⲡ ⲛⲟⲩⲧⲉ	ⲣⲱⲙⲉ	1
ⲡ ϭⲱⲗⲡ ⲉⲃⲟⲗ ⲙ ⲡⲉⲛ ϫⲟⲉⲓⲥ ⲓⲏⲥⲟⲩⲥ ⲡⲉ ⲭⲣⲓⲥⲧⲟⲥ	ϭⲱⲗⲡ	1
ⲛⲁⲓ ⲛⲧ ⲁ ⲩ ϣⲱⲡⲉ ⲛ ϩⲙϩⲁⲗ ⲙ ⲡ ϫⲟⲉⲓⲥ ⲡⲉϥ ⲭⲣⲓⲥⲧⲟⲥ ⲓⲏⲥⲟⲩⲥ	ⲛⲁⲓ	1
ϩⲉⲛ ⲕⲟⲓⲛⲱⲛⲓⲁ	ⲕⲟⲓⲛⲱⲛⲓⲁ	1
ϩⲉⲛ ⲕⲟⲩⲓ ⲙ ⲙⲁ ⲛ ϯϩⲁⲡ	ⲕⲟⲩⲓ	1
ⲛⲟⲩ ⲉⲓⲟⲧⲉ	ⲉⲓⲟⲧⲉ	1
ⲛⲟϭ ⲉⲣⲟ ⲕ	ⲛⲟϭ	1
ⲧⲉ ⲕⲣⲓⲥⲓⲥ ⲙ ⲡ ⲛⲟⲩⲧⲉ	ⲕⲣⲓⲥⲓⲥ	1
ⲧ ⲙⲛⲧⲥⲁⲃⲉ ⲛ ⲛ ⲥⲁⲃⲉⲉⲩ	ⲙⲛⲧⲥⲁⲃⲉ	1
ⲛⲟⲩ ⲉⲓⲟⲧⲉ ⲉⲧ ϩⲙ ⲡ ⲙⲁ ⲛⲙⲙ ⲉ	ⲉⲓⲟⲧⲉ	1
ⲟⲩ ϣⲏⲣⲉ ⲙ ⲙⲉⲣⲓⲧ	ϣⲏⲣⲉ	1
ⲧ ϩⲉ ⲛ ⲛⲁ ⲡ ⲛⲟⲩⲧⲉ	ϩⲉ	1
ⲡ ϣⲟⲉⲓϣ ⲉⲧ ϩⲁⲣⲟ ⲟⲩ ⲛ ⲛⲉⲧⲛ ⲟⲩⲉⲣⲏⲧⲉ	ϣⲟⲉⲓϣ	1
ⲧⲁⲙⲟ ⲟⲩ	ⲧⲁⲙⲟ	1
ⲛ ϭⲓⲛⲟⲩⲟⲟⲙ ⲛ ⲧ ϩⲏ	ϭⲓⲛⲟⲩⲟⲟⲙ	1
ϩⲉⲛ ⲛⲟϭ ⲙ ⲡ ⲉⲧ ϩⲟⲟⲩ	ⲡ	1
ⲧ ⲥⲟⲫⲓⲁ	ⲥⲟⲫⲓⲁ	1
ⲛ ϣⲟⲙⲧⲉ ⲛ ⲥⲕⲏⲛⲏ	ⲥⲕⲏⲛⲏ	1
ϩⲉⲛ ⲉⲛⲧⲟⲗⲏ ⲉⲧⲃⲉ ⲧ ⲙⲛⲧⲙⲁⲓⲣⲱⲙⲉ	ⲉⲛⲧⲟⲗⲏ	1
ϣⲃⲣⲣϩⲱⲃ ⲙ ⲡ ⲛⲟⲩⲧⲉ	ϣⲃⲣⲣϩⲱⲃ	1
ⲡ ⲙⲁⲕⲁⲣⲓⲟⲥ ⲁⲡⲁ ⲡⲁⲩⲗⲟⲥ	ⲡⲁⲩⲗⲟⲥ	1
ⲧⲉϥ ⲡⲓⲥⲧⲓⲥ	ⲡⲓⲥⲧⲓⲥ	1
ⲧ ⲙⲏⲧⲉ ⲛ ⲛ ⲣⲱⲙⲉ	ⲙⲏⲧⲉ	1
ⲃⲟⲉⲥ ⲡⲉ ⲉⲃⲟⲗ ϩⲛ ⲧ ⲥⲩⲅⲅⲉⲛⲉⲓⲁ ⲛ ⲁⲃⲓⲙⲉⲗⲉⲭ	ⲃⲟⲉⲥ	1
ⲧⲁ ϩⲩⲡⲟⲙⲟⲛⲏ	ϩⲩⲡⲟⲙⲟⲛⲏ	1
ⲡ ⲉⲧ ⲛⲧⲟⲟⲧ ⲕ	ⲡ	1
ⲛⲁ ϣⲃⲏⲣ	ϣⲃⲏⲣ	1
ⲛⲁ ϣⲏⲣⲉ	ϣⲏⲣⲉ	1
ⲡ ϩⲱⲃ ⲛ ⲧ ⲙⲛⲧϣⲙⲙⲟ	ϩⲱⲃ	1
ⲩ ⲉⲃⲓⲏⲛ ⲉ ϥ ϩⲓ ⲡ ⲧⲟⲟⲩ ⲛⲙⲙⲁ ⲕ	ⲉⲃⲓⲏⲛ	1
ⲛ ⲛⲩⲕⲧⲉⲣⲓⲥ ⲉⲧ ⲡⲏⲧ ⲉϩⲟⲩⲛ ⲏ ⲉϩⲣⲁⲓ ⲉ ϩⲉⲛ ⲙⲁ ⲛ ⲕⲁⲕⲉ ⲉ ⲩ ϣⲟⲕϩ ⲉⲙⲁⲧⲉ	ⲛⲩⲕⲧⲉⲣⲓⲥ	1
ⲧⲉⲕ ⲙⲟⲧⲛⲉⲥ	ⲙⲟⲧⲛⲉⲥ	1
ⲛ ϣⲏⲣⲉ ⲛ ⲛ ⲣⲱⲙⲉ	ϣⲏⲣⲉ	1
ⲛⲁ ϩⲓⲥⲉ	ϩⲓⲥⲉ	1
ϩⲟⲓⲛⲉ ⲉ ⲩ ϣⲱⲛⲉ	ϩⲟⲓⲛⲉ	1
ⲛⲉϩ ⲙ ⲙⲉ	ⲛⲉϩ	1
ⲛⲁ ⲡⲉ ⲡⲛⲉⲩⲙⲁ ⲙ ⲡ ⲛⲟⲩⲧⲉ	ⲛⲁ	1
ⲧⲉⲧⲛ ⲡⲁⲣⲁⲇⲟⲥⲓⲥ	ⲡⲁⲣⲁⲇⲟⲥⲓⲥ	1
ⲕⲟⲗⲁⲥⲓⲥ ⲉ ⲩ ⲛⲁϣⲧ	ⲕⲟⲗⲁⲥⲓⲥ	1
ϭⲉ ⲗⲁⲁⲩ ⲛ ⲣⲱⲙⲉ ⲛⲧⲁ ϥ	ⲗⲁⲁⲩ	1
ⲡ ϣⲟϫⲛⲉ ⲛ ϩⲣⲉⲃⲉⲕⲕⲁ ⲧ ⲙⲁⲁⲩ ⲛ ⲓⲁⲕⲱⲃ	ϣⲟϫⲛⲉ	1
ⲣⲱⲙⲉ ⲛ ⲣⲉϥϫⲓⲛϭⲟⲛⲥ	ⲣⲱⲙⲉ	1
ⲙⲁⲁⲃ ⲛ ⲕⲉⲛⲧⲏⲛⲁⲣⲓⲟⲛ ⲛ ⲛⲟⲩⲃ	ⲕⲉⲛⲧⲏⲛⲁⲣⲓⲟⲛ	1
ⲧ ⲙⲛⲧⲙⲁⲓⲣⲱⲙⲉ ⲙ ⲡ ⲛⲟⲩⲧⲉ	ⲙⲛⲧⲙⲁⲓⲣⲱⲙⲉ	1
ⲛⲁ ⲙⲉⲣⲁⲧⲉ	ⲙⲉⲣⲁⲧⲉ	1
ϭⲟⲣϭⲥ ⲙ ⲡ ⲇⲓⲁⲃⲟⲗⲟⲥ	ϭⲟⲣϭⲥ	1
ⲧⲉⲕ ⲁⲛⲁⲡⲁⲩⲥⲓⲥ ⲉⲧ ⲟⲩⲁⲁⲃ	ⲁⲛⲁⲡⲁⲩⲥⲓⲥ	1
ⲛⲉⲓ ⲙⲉⲉⲩⲉ ⲧⲏⲣ ⲟⲩ ⲙ ⲙⲛⲧϭⲱⲃ	ⲙⲉⲉⲩⲉ	1
ϩⲉⲛ ⲉⲥⲟⲟⲩ ⲛ ⲧ ⲙⲏⲧⲉ ⲛ ϩⲉⲛ ⲟⲩⲱⲛϣ	ⲉⲥⲟⲟⲩ	1
ⲧⲉ ⲑⲁⲗⲁⲥⲥⲁ ⲛ ⲧ ⲅⲁⲗⲓⲗⲁⲓⲁ	ⲑⲁⲗⲁⲥⲥⲁ	1
ⲧ ⲙⲛⲧⲁⲅⲁⲑⲟⲥ ⲙ ⲡⲉⲕ ⲥⲁϩ	ⲙⲛⲧⲁⲅⲁⲑⲟⲥ	1
ⲡⲁ ⲥⲟⲛ ⲙ ⲙⲉⲣⲓⲧ	ⲥⲟⲛ	1
ⲡⲉϥ ⲕⲉ ϣⲃⲏⲣ ⲥⲛⲁⲩ	ϣⲃⲏⲣ	1
ⲃⲁⲣⲑⲟⲗⲟⲙⲁⲓⲟⲥ	ⲃⲁⲣⲑⲟⲗⲟⲙⲁⲓⲟⲥ	1
ⲟⲩ ϫⲓⲛϭⲟⲛⲥ	ϫⲓⲛϭⲟⲛⲥ	1
ⲛ ⲣⲉϥⲉⲓⲣⲉ ⲙ ⲡ ϣⲁϫⲉ	ⲣⲉϥⲉⲓⲣⲉ	1
ⲛ ⲁⲅⲅⲉⲗⲟⲥ ⲙ ⲡ ⲛⲟⲩⲧⲉ	ⲁⲅⲅⲉⲗⲟⲥ	1
ⲡⲁⲓ ⲉⲧ ⲛⲁ ⲧⲥⲉⲃⲉ ⲉⲓⲁⲧ ϥ ⲉⲃⲟⲗ	ⲡⲁⲓ	1
ⲡ ⲁⲩⲏⲧ ⲙ ⲙⲟⲛⲁⲭⲟⲥ	ⲁⲩⲏⲧ	1
ⲧ ⲙⲛⲧϩⲁⲡⲗⲟⲩⲥ ⲙⲛ ⲡ ⲧⲃⲃⲟ ⲉⲧ ϫⲓ ⲉϩⲟⲩⲛ ⲉ ⲡⲉ ⲭⲣⲓⲥⲧⲟⲥ	ⲙⲛⲧϩⲁⲡⲗⲟⲩⲥ	1
ⲛ ⲉϫⲏⲩ	ⲉϫⲏⲩ	1
ⲡ ⲧⲣⲉ ⲩ ⲥϭⲏⲣ	ⲧⲣⲉ	1
ⲡ ⲣⲁⲛ ⲛ ⲧ ⲙⲉϩⲥⲛⲧⲉ	ⲣⲁⲛ	1
ⲡ ⲃⲟⲗ ⲛ ⲧ ⲕⲱⲙⲏ	ⲃⲟⲗ	1
ⲟⲩⲟⲛ ⲅⲁⲣ ⲛⲓⲙ	ⲟⲩⲟⲛ	1
ⲟⲩ ⲥϭⲣⲁϩⲧ	ⲥϭⲣⲁϩⲧ	1
ⲡ ⲟⲩⲱϣⲙ ⲧⲏⲣ ϥ	ⲟⲩⲱϣⲙ	1
ⲧⲉⲧⲛ ⲡⲁⲣⲁⲇⲟⲥⲓⲥ ⲛⲧ ⲁ ⲧⲉⲧⲛ ⲧⲁⲁ ⲥ ⲉⲧⲟⲟⲧ ⲟⲩ	ⲡⲁⲣⲁⲇⲟⲥⲓⲥ	1
ⲡ ϣⲏⲣⲉ	ϣⲏⲣⲉ	1
ⲡ ϣⲟⲣⲡ	ϣⲟⲣⲡ	1
ⲡ ϣⲱⲛⲉ	ϣⲱⲛⲉ	1
ⲡ ϩⲏⲃⲥ	ϩⲏⲃⲥ	1
ⲡ ϩⲏⲕⲉ	ϩⲏⲕⲉ	1
ⲡ ϩⲗⲗⲱ	ϩⲗⲗⲱ	1
ⲩ ϫⲁϫⲉ ⲛ ⲧ ϩⲉ ⲙ ⲡ ⲉⲧⲉ ⲙⲡ ⲕ ⲛⲁⲩ ⲉⲣⲟ ϥ ⲉⲛⲉϩ	ϫⲁϫⲉ	1
ⲡ ϫⲓⲥⲉ	ϫⲓⲥⲉ	1
ⲡ ⲉⲛⲧ ⲁ ⲓ ⲙⲉⲉⲩⲉ ⲇⲉ ⲉⲣⲟ ϥ	ⲡ	1
ⲡ ϫⲱⲱⲣ	ϫⲱⲱⲣ	1
ⲙ ⲡⲁⲣϩⲟⲓⲙⲓⲁ	ⲡⲁⲣϩⲟⲓⲙⲓⲁ	1
ⲡ ϭⲱⲛⲧ	ϭⲱⲛⲧ	1
ϩⲉⲛ ⲙⲛⲧϣⲟⲩϣⲉ	ⲙⲛⲧϣⲟⲩϣⲉ	1
ⲛⲉϥ ϣⲁϫⲉ	ϣⲁϫⲉ	1
ⲛ ϣⲏⲣⲉ ⲙ ⲡ ⲓⲥⲣⲁⲏⲗ	ϣⲏⲣⲉ	1
ⲛⲉϥ ϫⲁϫⲉ	ϫⲁϫⲉ	1
ⲩ ϩⲟⲣⲟⲙⲁ	ϩⲟⲣⲟⲙⲁ	1
ⲧ ⲙⲛⲧⲣⲙⲛϩⲏⲧ	ⲙⲛⲧⲣⲙⲛϩⲏⲧ	1
ⲡ ⲙⲁ ⲉⲧ ϥ ⲛⲁ ⲛⲕⲟⲧⲕ ⲛϩⲏⲧ ϥ	ⲙⲁ	1
ⲛⲉϥ ϣⲏⲣⲉ	ϣⲏⲣⲉ	1
ϩⲟⲓⲛⲉ ⲛϩⲏⲧ ⲟⲩ	ϩⲟⲓⲛⲉ	1
ⲟⲩ ϣⲁϫⲉ ⲛ ⲟⲩⲱⲧ	ϣⲁϫⲉ	1
ⲙ ⲡⲁⲓⲇⲉⲥ	ⲡⲁⲓⲇⲉⲥ	1
ⲥⲟⲩⲛⲧ ϥ	ⲥⲟⲩⲛⲧ	1
ⲓⲁⲕⲱⲃⲟⲥ ⲡ ϣⲏⲣⲉ ⲛ ⲁⲗⲫⲁⲓⲟⲥ	ⲓⲁⲕⲱⲃⲟⲥ	1
ϩⲁⲗⲩⲥⲓⲥ	ϩⲁⲗⲩⲥⲓⲥ	1
ϩⲁϩ ⲉ ⲩ ϩⲁⲧⲛ ⲛⲉⲩ ⲉⲣⲏⲩ ϩⲙ ⲡ ⲥⲱⲙⲁ · ⲉ ⲩ ⲟⲩⲏⲩ ⲇⲉ ⲉⲃⲟⲗ ⲛ ⲛⲉⲩ ⲉⲣⲏⲩ ϩⲙ ⲡ ϩⲏⲧ ⲁⲩⲱ ⲧ ⲁⲅⲁⲡⲏ	ϩⲁϩ	1
ⲧⲟⲟⲧ ⲟⲩ ⲛ ⲛⲟⲩ ⲉⲓⲟⲧⲉ	ⲧⲟⲟⲧ	1
ϩⲉⲛ ⲕⲉ ⲥⲙⲟⲧ ⲧⲏⲣ ⲟⲩ ⲉ ⲁ ⲩ ϫⲓⲧ ⲟⲩ ⲉ ⲁⲙⲁϩⲧⲉ ⲙⲙⲟ ⲟⲩ ϩⲉⲛ ⲁⲡⲟⲧ ⲉ ϩⲟⲣⲡ ⲟⲩ ⲛⲙ ϩⲉⲛ ⲝⲉⲥⲧⲏⲥ ⲛⲙ ϩⲉⲛ ⲭⲁⲗⲕⲓⲛ	ⲥⲙⲟⲧ	1
ⲡ ⲧⲟⲡⲟⲥ ⲛⲧ ⲁ ⲩ ϭⲱϫⲉ ⲙⲙⲟ ϥ ⲉ ⲡ ⲉⲥⲏⲧ ⲙ ⲡⲉ ⲥⲙⲟⲧ · ⲛ ⲟⲩ ⲙⲁ ⲉ ϥ ⲡⲟⲣϣ	ⲧⲟⲡⲟⲥ	1
ⲟⲩ ⲟⲓⲕⲟⲛⲟⲙⲓⲁ ⲇⲉ ⲛⲧⲉ ⲡ ⲛⲟⲩⲧⲉ ⲡ ⲙⲁⲓⲣⲱⲙⲉ	ⲟⲓⲕⲟⲛⲟⲙⲓⲁ	1
ⲟⲩ ⲕⲛⲁⲁⲩ ⲉ ϥ ⲙⲉϩ	ⲕⲛⲁⲁⲩ	1
ⲡⲉⲓ ⲥⲟⲟⲩ ⲛ ϣⲓ ⲛ ⲉⲓⲱⲧ	ϣⲓ	1
ⲛⲁ ϣⲃⲣⲕⲗⲏⲣⲟⲛⲟⲙⲟⲥ	ϣⲃⲣⲕⲗⲏⲣⲟⲛⲟⲙⲟⲥ	1
ⲡⲉⲕ ϣⲱⲛⲧ ⲡⲱⲕ	ϣⲱⲛⲧ	1
ⲡ ⲕⲱⲧⲉ ⲙⲙⲁⲩ ⲛ ⲧⲉ ϣⲧⲏⲛ ⲙ ⲡⲗϭⲉ	ⲕⲱⲧⲉ	1
ⲟⲩ ⲡⲉⲓⲑⲉ ⲛ ⲥⲟⲫⲓⲁ ⲛ ⲣⲱⲙⲉ	ⲡⲉⲓⲑⲉ	1
ⲟⲩ ⲧⲃⲁ ⲙ ⲡⲁⲓⲇⲁⲅⲱⲅⲟⲥ ϩⲙ ⲡⲉ ⲭⲣⲓⲥⲧⲟⲥ	ⲡⲁⲓⲇⲁⲅⲱⲅⲟⲥ	1
ⲧⲁⲓ ⲉⲧ ϩⲏⲡ ⲧ ⲉⲛⲧ ⲁ ⲡ ⲛⲟⲩⲧⲉ ⲡⲟⲣϫ ⲥ ⲉⲃⲟⲗ ϩⲁ ⲧ ϩⲏ ⲛ ⲛ ⲁⲓⲱⲛ ⲉ ⲡⲉⲛ ⲉⲟⲟⲩ	ⲧⲁⲓ	1
ⲡ ⲧⲃⲃⲟ ⲉⲧ ϫⲓ ⲉϩⲟⲩⲛ ⲉ ⲡⲉ ⲭⲣⲓⲥⲧⲟⲥ	ⲧⲃⲃⲟ	1
ⲥⲟⲟⲩ ⲛ ϩⲟⲟⲩ	ϩⲟⲟⲩ	1
ⲡ ⲉⲧ ⲟ ⲛ ⲛⲟϭ ⲉⲣⲟ ϥ	ⲡ	1
ⲛⲓ ⲁⲧⲛⲁ	ⲁⲧⲛⲁ	1
ⲕⲣⲟϥ ⲛ ϩⲏⲧ	ⲕⲣⲟϥ	1
ⲛⲉ ⲣϩⲙⲙⲉ	ⲣϩⲙⲙⲉ	1
ⲡ ⲛⲟⲩⲧⲉ ⲡ ⲕⲟⲓⲛⲱⲛⲟⲥ ⲁⲛ ⲡⲉ ⲛ ⲛ ⲥⲟⲟⲛⲉ ⲛ ⲛ ⲣⲉϥⲧⲱⲣⲡ	ⲕⲟⲓⲛⲱⲛⲟⲥ	1
ⲧⲉⲕ ϭⲓⲛⲟⲩⲱϣⲃ	ϭⲓⲛⲟⲩⲱϣⲃ	1
ⲟⲩ ⲣⲙⲛⲧⲟⲟⲩ ⲛ ⲧⲉⲕ ϩⲉ	ⲣⲙⲛⲧⲟⲟⲩ	1
ⲧⲉⲓ ⲙⲁⲥⲧⲓⲅⲝ	ⲙⲁⲥⲧⲓⲅⲝ	1
ⲡ ⲉⲧⲉ ⲛ ϣⲟⲟⲡ ⲁⲛ	ⲡ	1
ⲡⲉϥ ϣⲏⲣⲉ ⲓⲏⲥⲟⲩⲥ ⲡⲉ ⲭⲣⲓⲥⲧⲟⲥ ⲡⲉⲛ ϫⲟⲉⲓⲥ	ⲓⲏⲥⲟⲩⲥ	1
ϯ ⲡⲩⲅⲏ ⲙ ⲙⲟⲟⲩ	ⲡⲩⲅⲏ	1
ⲛ ⲁⲝⲓⲱⲙⲁ ⲛ ⲧ ⲙⲛⲧⲥⲧⲣⲁⲧⲏⲗⲁⲧⲏⲥ	ⲁⲝⲓⲱⲙⲁ	1
ⲡ ⲙⲁ ⲉⲧⲉ ⲣ ⲁ ⲟⲩⲱϩ ⲛϩⲏⲧ ϥ	ⲙⲁ	1
ⲡ ⲡⲉⲧⲟⲩⲁⲁⲃ ⲇⲉ ⲓⲱⲥⲏⲫ	ⲓⲱⲥⲏⲫ	1
ⲡ ⲥⲱⲙⲁ ⲛ ⲧ ⲙⲁⲕⲁⲣⲓⲁ ϩⲓⲗⲗⲁⲣⲓⲁ ⲧ ϣⲉⲉⲣⲉ ⲙ ⲡ ⲣⲣⲟ ⲍⲏⲛⲱⲛ	ⲥⲱⲙⲁ	1
ϣⲱⲛⲉ ⲛ ⲥⲱⲙⲁⲧⲓⲕⲟⲛ	ϣⲱⲛⲉ	1
ⲧⲉ ⲭⲁⲣⲓⲥ ⲙ ⲡ ϫⲟⲉⲓⲥ	ⲭⲁⲣⲓⲥ	1
ⲛ ⲉⲧ ϣⲟⲟⲡ ⲧⲏⲣ ⲟⲩ ⲛ ⲭⲁⲓⲗⲉⲱⲛ ⲙⲛ ⲙⲁⲁⲗⲱⲛ	ⲛ	1
ⲥⲟⲩⲉⲛⲧ ⲟⲩ	ⲥⲟⲩⲉⲛⲧ	1
ⲛ ⲉⲛⲧ ⲁ ⲩ ⲟⲩⲱⲙ	ⲛ	1
ⲡ ⲧⲉⲗⲱⲛⲏⲥ	ⲧⲉⲗⲱⲛⲏⲥ	1
ⲥⲟⲟⲩⲛ ⲛⲓⲙ	ⲥⲟⲟⲩⲛ	1
ϭⲁⲙⲟⲩⲗ	ϭⲁⲙⲟⲩⲗ	1
ⲟⲩ ⲙⲏⲏϣⲉ ⲉ ⲩ ⲙⲟⲕϩ ⲛ ϣⲱⲛⲉ ⲉ ⲩ ϣⲟⲃⲉ	ⲙⲏⲏϣⲉ	1
ⲃⲏⲇⲥⲁⲓⲇⲁⲛ	ⲃⲏⲇⲥⲁⲓⲇⲁⲛ	1
ⲟⲩ ⲙⲛⲧϭⲱⲃ	ⲙⲛⲧϭⲱⲃ	1
ⲛⲓ ⲃⲗⲗⲉ , ⲉⲧⲉ ⲙⲛ ⲃⲁⲗ ⲙⲙⲟ ⲟⲩ	ⲃⲗⲗⲉ	1
ⲁⲡⲁ ⲡⲁⲥⲧⲁⲙⲱⲛ	ⲡⲁⲥⲧⲁⲙⲱⲛ	1
ⲧ ⲟⲩⲓ ⲙⲙⲟ ⲟⲩ	ⲟⲩⲓ	1
ⲡ ⲏⲓ ⲙ ⲡ ⲓⲥⲣⲁⲏⲗ	ⲏⲓ	1
ⲩ ϣⲁϫⲉ ⲉⲧⲃⲉ ⲡⲉⲛ ⲉⲓⲱⲧ ϩⲏⲗⲓⲁⲥ ⲡⲉ ⲑⲉⲥⲃⲓⲧⲏⲥ	ϣⲁϫⲉ	1
ⲡ ⲡⲉⲓⲣⲁⲥⲙⲟⲥ	ⲡⲉⲓⲣⲁⲥⲙⲟⲥ	1
ⲛⲁ ⲛⲉ ⲫⲁⲣⲓⲥⲥⲁⲓⲟⲥ	ⲛⲁ	1
ⲛ ⲕⲉ ⲣⲣⲱⲟⲩ ⲙ ⲙⲁⲓⲛⲟⲩⲧⲉ	ⲣⲣⲱⲟⲩ	1
ⲕⲉ ⲛⲟϭ ⲙ ⲙⲏⲏϣⲉ ⲉⲃⲟⲗ ϩⲛ ⲧ ⲓⲇⲟⲩⲙⲁⲓⲁ ⲙⲛ ⲡⲉ ⲕⲣⲟ ⲙ ⲡ ⲓⲟⲣⲇⲁⲛⲏⲥ ⲙⲛ ⲡ ⲕⲱⲧⲉ ⲛ ⲧⲩⲣⲟⲥ ⲙⲛ ⲥⲓⲇⲱⲛ	ⲙⲏⲏϣⲉ	1
ⲡ ⲉⲛⲧ ⲁ ϥ ⲉⲓⲣⲉ ⲙ ⲡⲉⲓ ϩⲱⲃ ⲛ ⲧⲉⲓ ϩⲉ	ⲡ	1
ⲡ ϫⲟⲉⲓⲥ ⲡ ⲛⲟⲩⲧⲉ ⲙ ⲡ ⲓⲥⲣⲁⲏⲗ ⲡ ⲉⲛⲧ ⲁ ϯ ⲡⲟⲩ ⲟⲩⲟⲓ ⲉϩⲟⲩⲛ ⲉⲣⲟ ϥ ⲉ ⲧⲣ ⲉ ⲛⲁϩⲧⲉ ϩⲁ ⲛⲉϥ ⲧⲛϩ	ϫⲟⲉⲓⲥ	1
ⲛⲁ ⲧⲁϭⲥⲉ	ⲧⲁϭⲥⲉ	1
ⲡⲗⲉⲟⲛⲉⲝⲓⲁ	ⲡⲗⲉⲟⲛⲉⲝⲓⲁ	1
ⲛ ⲕⲟⲟⲩⲉ ⲧⲏⲣ ⲟⲩ ⲉⲧ ⲥⲏϩ ϩⲣⲁⲓ ϩⲛ ⲛⲉⲓ ⲭⲁⲣⲧⲏⲥ ⲉⲧ ⲥⲏϩ ϫⲓⲛ ⲛ ϣⲟⲣⲡ	ⲕⲟⲟⲩⲉ	1
ⲡⲉⲛ ϫⲟⲉⲓⲥ ⲓⲏⲥⲟⲩⲥ ⲡⲉⲛ ⲉⲓⲱⲧ	ⲓⲏⲥⲟⲩⲥ	1
ⲡ ⲉⲧⲉ ⲙⲛⲧⲁ ϥ	ⲡ	1
ϣⲉϩⲙⲉ	ϣⲉϩⲙⲉ	1
ⲟⲩ ⲙⲣⲣⲉ ⲛ ⲛⲏⲥⲧⲉⲓⲁ	ⲙⲣⲣⲉ	1
ⲗⲁⲁⲩ ⲛ ⲥⲟⲫⲟⲥ	ⲗⲁⲁⲩ	1
ⲟⲩ ϩⲱⲃ ⲉ ϥ ⲟ ⲛ ⲛⲟⲃⲉ	ϩⲱⲃ	1
ⲛ ⲉⲧ ⲙⲟⲟϣⲉ ⲛⲉ ϩⲛ ⲧ ⲡⲁⲣⲣⲏⲥⲓⲁ ⲛ ϩⲩⲡⲟⲧⲁⲅⲏ ⲛⲓⲙ ϩⲓ ⲙⲛⲧⲥⲧⲙⲏⲧ ⲛⲓⲙ ϩⲓ ϩⲱⲃ ⲛⲓⲙ ⲛ ⲁⲅⲁⲑⲟⲛ	ⲛ	1
ⲏⲥⲁⲓⲁⲥ ⲡⲉ ⲡⲣⲟⲫⲏⲧⲏⲥ	ⲏⲥⲁⲓⲁⲥ	1
ⲩ ϭⲓⲥ ⲧⲃⲁ ⲛ ⲣⲱⲙⲉ	ⲣⲱⲙⲉ	1
ⲡ ⲕⲉ ⲥⲁⲃⲃⲁⲧⲟⲛ	ⲥⲁⲃⲃⲁⲧⲟⲛ	1
ⲡ ⲛⲟⲩⲧⲉ ⲛ ⲛⲉϥ ⲉⲓⲟⲧⲉ	ⲛⲟⲩⲧⲉ	1
ⲡ ⲙⲁⲙⲙⲱⲛⲁⲥ	ⲙⲁⲙⲙⲱⲛⲁⲥ	1
ⲛ ⲉⲧ ϩⲙⲟⲟⲥ	ⲛ	1
ⲛⲁ ϣⲉⲉⲣⲉ ϣⲏⲙ	ϣⲉⲉⲣⲉ	1
ⲡ ⲙⲁ ⲉⲛⲧ ⲁ ⲩ ⲥⲁⲛⲟⲩϣ ⲉ ⲛϩⲏⲧ ϥ ⲕⲁⲧⲁ ⲡ ⲛⲟⲩⲧⲉ ⲁⲩⲱ ⲕⲁⲧⲁ ⲡ ⲕⲟⲥⲙⲟⲥ	ⲙⲁ	1
ⲧ ⲙⲁⲕⲁⲣⲓⲁ ϩⲓⲗⲗⲁⲣⲓⲁ ⲧ ϣⲉⲉⲣⲉ ⲙ ⲡ ⲣⲣⲟ ⲍⲏⲛⲱⲛ	ϩⲓⲗⲗⲁⲣⲓⲁ	1
ⲥⲩⲛⲁⲅⲱⲅⲏ ⲧⲏⲣ ⲟⲩ ⲙ ⲡ ϫⲟⲉⲓⲥ	ⲥⲩⲛⲁⲅⲱⲅⲏ	1
ⲟⲩ ⲛⲟϭ ⲛ ⲁⲛⲁⲭⲱⲣⲏⲧⲏⲥ ⲡⲁⲓ ⲉⲧⲉ ⲙ ⲡ ⲕⲟⲥⲙⲟⲥ ⲧⲏⲣ ϥ ⲙⲡϣⲁ ⲁⲛ ⲛ ⲟⲩ ⲥϣ ⲛ ⲧⲁϭⲥⲉ ⲛ ⲟⲩⲱⲧ ⲛⲧⲉ ⲛⲉϥ ⲟⲩⲉⲣⲏⲧⲉ	ⲁⲛⲁⲭⲱⲣⲏⲧⲏⲥ	1
ⲟⲩ ⲁⲣⲟⲟⲩⲉ	ⲁⲣⲟⲟⲩⲉ	1
ⲙⲁⲓⲧⲟⲉ ⲛ ϩⲟⲩⲟ	ⲙⲁⲓⲧⲟⲉ	1
ⲗⲁⲁⲩ ⲇⲉ ⲙ ⲡⲗⲉⲟⲛⲉⲕⲧⲏⲥ	ⲗⲁⲁⲩ	1
ⲟⲩ ⲙⲉⲉⲩⲉ ⲛ ⲟⲩⲱⲧ ⲛⲧⲉ ⲁⲡⲁ ⲁⲛⲧⲱⲛⲓⲟⲥ	ⲙⲉⲉⲩⲉ	1
ⲡⲁⲣⲑⲉⲛⲟⲥ ϩⲙ ⲡⲉϥ ⲥⲱⲙⲁ	ⲡⲁⲣⲑⲉⲛⲟⲥ	1
ⲧ ⲕⲉ ⲟⲩⲉⲓ	ⲟⲩⲉⲓ	1
ⲛ ⲉⲛⲧ ⲁ ⲩ ϣⲱⲡⲉ ⲛⲁ ϥ ⲉⲃⲟⲗ ϩⲛ ⲍⲉⲗⲫⲁ ⲙⲛ ⲃⲁⲗⲗⲁ	ⲛ	1
ⲡⲁ ⲕⲣⲁⲧⲟⲥ	ⲕⲣⲁⲧⲟⲥ	1
ϩⲉⲛ ϩⲟⲓⲧⲉ ⲉ ⲩ ϫⲟⲟⲣ	ϩⲟⲓⲧⲉ	1
ⲡ ⲉⲧ ⲛⲁ ⲧⲱϣ ⲛ ⲟⲩ ϩⲱⲃ ⲉ ϥ ⲟ ⲛ ⲛⲟⲃⲉ ⲉ ⲡ ⲉⲧ ϩⲓⲧⲟⲩⲱ ϥ	ⲡ	1
ⲧ ⲥⲟⲫⲓⲁ ⲛ ⲛ ⲥⲟⲫⲟⲥ	ⲥⲟⲫⲓⲁ	1
ϣⲏⲧ ⲛ ϩⲧⲟ ⲉ ⲩ ⲟⲩⲟⲃϣ	ϩⲧⲟ	1
ⲓⲱϩⲁⲛⲛⲏⲥ ⲡⲉϥ ⲥⲟⲛ	ⲓⲱϩⲁⲛⲛⲏⲥ	1
ⲙⲏⲧ ⲛ ϣⲉ ⲛ ϭⲓⲛⲟⲩⲃⲁⲗ ⲉ ⲩ ⲡⲗⲉⲁ ϩⲛ ⲧ ⲑⲁⲗⲁⲥⲥⲁ	ϭⲓⲛⲟⲩⲃⲁⲗ	1
ⲛⲉϩϣⲗϥ	ⲛⲉϩϣⲗϥ	1
ⲟⲩ ϣⲃⲏⲣ · ϩⲱⲱ ⲕ ⲟⲛ ⲛⲧⲉ ⲡ ⲛⲟⲩⲧⲉ	ϣⲃⲏⲣ	1
ϩⲉⲛ ⲉϫⲏⲩ	ⲉϫⲏⲩ	1
ⲁⲡⲁⲛⲧⲁ	ⲁⲡⲁⲛⲧⲁ	1
ⲡ ⲛⲟϭ ⲉⲧ ⲛϩⲏⲧ ⲟⲩ	ⲛⲟϭ	1
ⲡ ⲁⲣⲭⲓⲙⲁⲛⲇⲣⲓⲧⲏⲥ	ⲁⲣⲭⲓⲙⲁⲛⲇⲣⲓⲧⲏⲥ	1
ⲛⲁ ϩⲙϩⲁⲗ ⲛⲉ ⲡⲣⲟⲫⲏⲧⲏⲥ	ϩⲙϩⲁⲗ	1
ⲡ ϫⲁϫⲉ ⲉⲧ ϯ ⲟⲩⲃⲏ ⲛ ⲛ ⲟⲩⲟⲉⲓϣ ⲛⲓⲙ	ϫⲁϫⲉ	1
ⲟⲩ ⲣⲱⲙⲉ ⲛ ⲥⲁⲃⲉ	ⲣⲱⲙⲉ	1
ⲡⲉ ⲭⲣⲓⲥⲧⲟⲥ ⲓⲏⲥⲟⲩⲥ ⲡⲉⲛ ϫⲟⲉⲓⲥ · ⲁⲩⲱ ⲡⲉⲛ ⲛⲟⲩⲧⲉ · ⲁⲩⲱ ⲡⲉⲛ ⲥⲱⲧⲏⲣ	ⲓⲏⲥⲟⲩⲥ	1
ⲟⲛⲛⲟⲫⲣⲓⲟⲥ	ⲟⲛⲛⲟⲫⲣⲓⲟⲥ	1
ⲡ ⲃⲏⲙⲁ · ⲉⲧ ϩⲁ ϩⲟⲧⲉ · ⲙ ⲡ ⲛⲟⲩⲧⲉ	ⲃⲏⲙⲁ	1
ⲡ ⲛⲟⲩⲧⲉ ⲉⲧ ϣⲟⲟⲡ ⲛⲙⲙⲁ ϥ	ⲛⲟⲩⲧⲉ	1
ⲛ ϩⲓⲥⲉ ⲉⲧ ϥ ϣⲟⲟⲡ ⲛϩⲏⲧ ⲟⲩ	ϩⲓⲥⲉ	1
ⲡ ⲛⲁⲩ ⲛ ϣⲱⲣⲡ	ⲛⲁⲩ	1
ⲁⲃⲓⲁⲑⲁⲣ ⲡ ⲁⲣⲭⲓⲉⲣⲉⲩⲥ	ⲁⲃⲓⲁⲑⲁⲣ	1
ⲅⲉⲛⲛⲏⲥⲁⲣⲉⲧ	ⲅⲉⲛⲛⲏⲥⲁⲣⲉⲧ	1
ⲛ ⲛⲟⲃⲣⲉ	ⲛⲟⲃⲣⲉ	1
ⲛ ⲛⲟⲩⲧⲉ	ⲛⲟⲩⲧⲉ	1
ⲡⲁ ⲡ ⲉⲧ ⲧⲥⲟ	ⲡⲁ	1
ⲟⲩ ⲙⲛⲧⲉⲩⲥⲉⲃⲏⲥ	ⲙⲛⲧⲉⲩⲥⲉⲃⲏⲥ	1
ⲡⲁ ϩⲏⲡⲁⲣ ⲉⲧ ϣⲱⲛⲉ	ϩⲏⲡⲁⲣ	1
ϩⲉⲛ ⲉⲡⲟⲓⲕⲓⲟⲛ ⲟⲛ ⲛⲉ ⲛ ϯⲙⲉ	ⲉⲡⲟⲓⲕⲓⲟⲛ	1
ⲛ ⲉⲧⲉⲣⲉ ⲡ ⲛⲟⲩⲧⲉ ⲛⲁ ϩⲟϫϩϫ ⲉⲃⲟⲗ ϩⲓⲧⲟⲟⲧ ⲟⲩ	ⲛ	1
ⲡ ϣⲟⲩϣⲟⲩ ⲙ ⲡⲉ ⲡⲛⲉⲩⲙⲁ ⲉⲧⲉ ⲩⲛⲧⲁ ⲕ ⲥϥ	ϣⲟⲩϣⲟⲩ	1
ⲧⲉⲥ ϣⲉⲗⲉⲉⲧ	ϣⲉⲗⲉⲉⲧ	1
ⲧ ⲟⲩⲓ ⲧ ⲟⲩⲓ	ⲟⲩⲓ	1
ⲡⲉⲕ ⲉⲓⲱⲧ ⲡ ⲇⲓⲁⲃⲟⲗⲟⲥ ⲉⲧ ⲟⲩⲏϩ ⲛϩⲏⲧ ⲕ ⲉⲧ ⲕ ϩⲉⲗⲡⲓⲍⲉ ⲉⲣⲟ ϥ	ⲉⲓⲱⲧ	1
ⲧⲁ ⲥⲧⲟⲗⲏ	ⲥⲧⲟⲗⲏ	1
ⲙⲉⲥⲟⲩⲁⲫⲓ	ⲙⲉⲥⲟⲩⲁⲫⲓ	1
ⲛ ⲥⲩⲛⲕⲗⲏⲧⲓⲕⲟⲥ	ⲥⲩⲛⲕⲗⲏⲧⲓⲕⲟⲥ	1
ⲡ ϫⲱⲕ ⲉⲃⲟⲗ ⲙ ⲡ ⲟⲩⲱϣ	ϫⲱⲕ	1
ⲡ ⲏⲓ ⲛ ⲛⲉⲕ ⲉⲓⲟⲧⲉ	ⲏⲓ	1
ⲧⲁ ⲙⲉϩϣⲟⲙⲧⲉ ⲛ ⲣⲟⲙⲡⲉ	ⲣⲟⲙⲡⲉ	1
ⲡ ⲧⲣⲉ ⲛ ϭⲱϣⲧ ⲉⲃⲟⲗ	ⲧⲣⲉ	1
ⲛⲉⲧⲛ ϩⲃⲏⲩⲉ ⲉⲧ ⲛⲁⲛⲟⲩ ⲟⲩ	ϩⲃⲏⲩⲉ	1
ⲡⲉ ⲕⲣⲟ ⲙ ⲡ ⲓⲟⲣⲇⲁⲛⲏⲥ	ⲕⲣⲟ	1
ⲟⲩ ⲑⲁⲃ ⲁⲛ ⲛ ⲕⲁⲕⲓⲁ ϩⲓ ⲡⲟⲛⲏⲣⲓⲁ	ⲑⲁⲃ	1
ⲛⲉ ⲡⲛⲉⲩⲙⲁⲧⲓⲕⲟⲛ ⲛ ⲧ ⲡⲟⲛⲏⲣⲓⲁ ⲉⲧ ϩⲁ ⲙ ⲡⲏⲩⲉ	ⲡⲛⲉⲩⲙⲁⲧⲓⲕⲟⲛ	1
ⲛ ⲕⲉ ⲧⲙⲙⲟ ⲉⲧ ϩⲏⲛ ⲉϩⲟⲩⲛ	ⲧⲙⲙⲟ	1
ⲛⲉ ⲉⲃⲟⲗ ϩⲛ ⲧⲉⲓ ⲉⲡⲓⲥⲧⲟⲗⲏ	ⲉⲡⲓⲥⲧⲟⲗⲏ	1
ⲙ ⲙⲁ ⲛ ϣⲓⲛⲉ ⲛ ⲛ ⲇⲁⲓⲙⲱⲛ	ⲙⲁ	1
ⲧⲁ ⲧⲁⲝⲓⲥ	ⲧⲁⲝⲓⲥ	1
ⲟⲩ ⲙⲛⲧⲣⲉϥϫⲱϩⲙ	ⲙⲛⲧⲣⲉϥϫⲱϩⲙ	1
ⲧ ⲣϫⲛⲟⲟⲩ	ⲣϫⲛⲟⲟⲩ	1
ⲩ ⲡⲟⲣⲛⲉⲓⲁ ⲛϩⲏⲧ ⲧⲏⲩⲧⲛ	ⲡⲟⲣⲛⲉⲓⲁ	1
ⲡ ⲉⲧⲉ ⲛ ⲥⲉ ⲉⲓⲙⲉ ⲉⲣⲟ ϥ ⲁⲛ	ⲡ	1
ⲡ ⲡⲉⲧϣⲟⲩⲉⲓⲧ ⲙ ⲡⲉⲛ ϩⲏⲧ	ⲡⲉⲧϣⲟⲩⲉⲓⲧ	1
ⲧⲉⲥ ϩⲁⲉⲓⲃⲉⲥ	ϩⲁⲉⲓⲃⲉⲥ	1
ⲧⲉⲓ ⲕⲧⲏⲥⲓⲥ ⲛ ⲧⲉⲓ ⲙⲓⲛⲉ	ⲕⲧⲏⲥⲓⲥ	1
ⲟⲩ ⲙⲛⲧⲣⲉϥϩⲓⲗⲁ	ⲙⲛⲧⲣⲉϥϩⲓⲗⲁ	1
ⲧ ϭⲓϫ ⲙ ⲡ ϫⲟⲉⲓⲥ	ϭⲓϫ	1
ϩⲁϩ ⲇⲉ ⲟⲛ ⲉ ⲩ ϩⲁⲧⲛ ⲛⲉⲩ ⲉⲣⲏⲩ ⲁⲛ ϩⲙ ⲡ ⲥⲱⲙⲁ · ⲉ ⲩ ϩⲁⲧⲛ ⲛⲉⲩ ⲉⲣⲏⲩ ⲛ ⲛⲁⲩ ⲛⲓⲙ ϩⲛ ⲧ ⲁⲅⲁⲡⲏ ⲙ ⲡⲉ ⲭⲣⲓⲥⲧⲟⲥ ⲙⲛ ⲧ ⲁⲅⲁⲡⲏ ⲙ ⲡⲉ ⲡⲛⲉⲩⲙⲁ ⲁⲩⲱ ⲡ ⲟⲩⲱϣ ⲛ ⲓⲏⲥⲟⲩⲥ	ϩⲁϩ	1
ⲧⲉ ⲡⲣⲁⲝⲓⲥ ⲉⲧ ϩⲏⲡ	ⲡⲣⲁⲝⲓⲥ	1
ⲛⲉ ⲩϩⲟⲟⲣ	ⲩϩⲟⲟⲣ	1
ⲧ ϭⲓϫ ⲛ ⲛ ⲉⲧ ⲑⲗⲓⲃⲉ ⲙⲙⲟ ⲟⲩ	ϭⲓϫ	1
ⲡⲉⲕ ⲙⲉⲉⲩⲉ ⲧⲏⲣ ϥ	ⲙⲉⲉⲩⲉ	1
ⲁⲣⲭⲱⲛ ⲁⲛ ⲧⲉ ⲙ ⲡⲉⲓ ⲁⲓⲱⲛ ⲛⲁⲓ ⲉⲧ ⲛⲁ ⲟⲩⲱⲥϥ	ⲁⲣⲭⲱⲛ	1
ϩⲉⲛ ⲣⲉϥⲧⲁϣⲉⲟⲉⲓϣ ⲉⲧⲉ ⲛⲁⲓ ⲛⲉ · ⲛⲉϥ ⲁⲡⲟⲥⲧⲟⲗⲟⲥ ⲛⲉ ⲉⲧ ⲟⲩⲁⲁⲃ	ⲣⲉϥⲧⲁϣⲉⲟⲉⲓϣ	1
ⲁⲅⲅⲉⲗⲟⲥ ⲉ ⲙⲛ ⲏⲡ	ⲁⲅⲅⲉⲗⲟⲥ	1
ⲙⲛⲧⲥⲛⲟⲟⲩⲥ ⲅⲁⲣ ⲛ ⲣⲟⲙⲡⲉ	ⲙⲛⲧⲥⲛⲟⲟⲩⲥ	1
ϩⲛⲏ ⲧⲛ	ϩⲛⲏ	1
ⲡ ⲣⲉϥⲣⲛⲟⲃⲉ ⲡ ⲥⲁⲧⲁⲛⲁⲥ	ⲥⲁⲧⲁⲛⲁⲥ	1
ⲡ ⲙⲟⲩⲥ ⲙ ⲡⲉϥ ⲧⲟⲟⲩⲉ	ⲙⲟⲩⲥ	1
ⲡⲁⲓ ⲉⲛⲧ ⲁ ϭⲱ ⲙⲛ ⲛⲉϥ ϣⲉⲉⲣⲉ ϣⲏⲙ	ⲡⲁⲓ	1
ⲡ ⲱⲃϣ ⲛ ⲛ ⲉⲛⲧⲟⲗⲏ ⲙ ⲡ ⲛⲟⲩⲧⲉ	ⲱⲃϣ	1
ⲧⲁ ⲡⲉⲓ ⲁⲓⲱⲛ	ⲧⲁ	1
ⲧⲉϥ ⲙⲛⲧⲕⲟⲩⲓ	ⲙⲛⲧⲕⲟⲩⲓ	1
ⲟⲩ ⲡⲣⲟⲥⲫⲟⲣⲁ	ⲡⲣⲟⲥⲫⲟⲣⲁ	1
ⲛⲉⲧⲛ ⲧⲃⲛⲟⲟⲩⲉ	ⲧⲃⲛⲟⲟⲩⲉ	1
ⲛⲉ ϩⲟⲓⲧⲉ ⲉⲧ ⲧⲟ ϩⲓⲱⲱ ϥ	ϩⲟⲓⲧⲉ	1
ⲡ ⲡⲟⲛⲏⲣⲟⲥ	ⲡⲟⲛⲏⲣⲟⲥ	1
ⲛ ⲇⲱⲣⲟⲛ ⲙ ⲡ ⲛⲟⲩⲧⲉ	ⲇⲱⲣⲟⲛ	1
ⲉⲕⲕⲗⲏⲥⲓⲁ ⲛ ϣⲓⲏⲧ	ⲉⲕⲕⲗⲏⲥⲓⲁ	1
ⲡⲉⲓ ϭⲙϣⲓⲛⲉ	ϭⲙϣⲓⲛⲉ	1
ⲛ ⲉⲧ ⲥⲟⲟⲩⲛ ⲙⲙⲟ ⲕ	ⲛ	1
ⲧ ⲟⲓⲕⲟⲛⲟⲙⲓⲁ ⲛⲧ ⲁ ⲕ ⲧⲁⲛϩⲟⲩⲧ ⲉⲣⲟ ⲥ	ⲟⲓⲕⲟⲛⲟⲙⲓⲁ	1
ⲯⲩⲭⲏ ⲛⲓⲙ ⲛ ⲣⲱⲙⲉ ⲉⲧ ⲣϩⲱⲃ ⲉ ⲡ ⲡⲉⲧϩⲟⲟⲩ	ⲯⲩⲭⲏ	1
ⲧⲉⲕ ⲇⲓⲕⲁⲓⲟⲥⲩⲛⲏ	ⲇⲓⲕⲁⲓⲟⲥⲩⲛⲏ	1
ϩⲟⲓⲛⲉ ⲛ ⲛⲉϥ ⲙⲁⲑⲏⲧⲏⲥ	ϩⲟⲓⲛⲉ	1
ⲧ ⲙⲏⲧⲉ ⲛ ⲧ ⲑⲁⲗⲁⲥⲥⲁ	ⲙⲏⲧⲉ	1
ⲧⲉⲓ ⲃⲱ ⲛ ⲕⲛⲧⲉ	ⲃⲱ	1
ⲏⲥⲁⲩ · ⲡⲉϥ ⲥⲟⲛ	ⲏⲥⲁⲩ	1
ⲡ ⲉⲛⲉⲭⲉⲣⲟⲛ ⲙ ⲡⲉⲧⲛ ⲛⲟⲩⲧⲉ	ⲉⲛⲉⲭⲉⲣⲟⲛ	1
ⲡⲉⲛ ⲣⲉϥⲣⲡⲉⲧⲛⲁⲛⲟⲩϥ ⲛⲁ ⲛ ⲙⲁⲩⲁⲁ ϥ	ⲣⲉϥⲣⲡⲉⲧⲛⲁⲛⲟⲩϥ	1
ⲛⲉ ⲥⲛⲏⲩ , ⲉⲧⲉⲣⲉ ⲟⲩⲏϩ ⲛⲙⲙⲁ ⲩ	ⲥⲛⲏⲩ	1
ⲛ ⲟⲩⲁⲙⲟⲙⲉ	ⲟⲩⲁⲙⲟⲙⲉ	1
ⲡ ⲥⲁ ⲥⲛⲁⲩ	ⲥⲁ	1
ⲛⲓ ⲣⲱⲙⲉ ⲉⲧ ⲙⲉⲉⲩⲉ ⲉ ϩⲉⲛ ⲡⲟⲛⲏⲣⲟⲛ ⲛ ⲛⲁⲩ ⲛⲓⲙ ⲉϩⲟⲩⲛ ⲉⲣⲟ ⲟⲩ	ⲣⲱⲙⲉ	1
ⲁⲡⲁ ⲕⲁⲥⲓⲁⲛⲟⲥ	ⲕⲁⲥⲓⲁⲛⲟⲥ	1
ⲕⲱ ⲛⲥⲱ ϥ ⲛ ⲟⲩ ⲗⲁⲟⲥ ⲉⲧⲃⲉ ⲛⲉⲩ ϩⲃⲏⲩⲉ ⲉⲧ ϩⲟⲟⲩ ⲕⲁⲧⲁ ⲡ ϣⲁϫⲉ ⲙ ⲡⲉ ⲡⲣⲟⲫⲏⲧⲏⲥ	ⲕⲱ	1
ⲛ ⲥⲣⲉϥⲣⲓϥⲉ	ⲥⲣⲉϥⲣⲓϥⲉ	1
ⲛ ⲁⲣⲭⲏ	ⲁⲣⲭⲏ	1
ⲕⲟⲣⲓⲛⲑⲟⲥ	ⲕⲟⲣⲓⲛⲑⲟⲥ	1
ⲧⲉⲓ ϭⲟⲧ	ϭⲟⲧ	1
ϭⲓϫ ⲥⲛⲧⲉ	ϭⲓϫ	1
ⲡ ⲉⲧ ⲛⲁ ϣⲱⲡ ⲉⲣⲟ ϥ ⲛ ⲟⲩⲁ ⲛ ⲧ ϩⲉ ⲛ ⲛⲓ ϣⲏⲣⲉ ϣⲏⲙ ϩⲙ ⲡⲁ ⲣⲁⲛ	ⲡ	1
ⲁⲛⲁⲅⲛⲱⲥⲧⲏⲥ	ⲁⲛⲁⲅⲛⲱⲥⲧⲏⲥ	1
ⲛⲁ ⲛⲟⲃⲉ ⲉⲧ ⲟϣ	ⲛⲟⲃⲉ	1
ⲥⲟⲟⲩ ⲛ ϣⲓ ⲛ ⲉⲓⲱⲧ	ϣⲓ	1
ⲛ ⲉⲓⲱⲧ	ⲉⲓⲱⲧ	1
ⲛ ⲉⲣⲏⲧ	ⲉⲣⲏⲧ	1
ⲟⲩ ⲙⲁ ⲉ ϥ ⲡⲟⲣϣ	ⲙⲁ	1
ⲉⲛⲧⲟⲗⲏ ⲛ ⲣⲱⲙⲉ	ⲉⲛⲧⲟⲗⲏ	1
ⲧⲉ ⲫⲟⲓⲛⲓⲕⲏ ⲛ ⲧ ⲥⲩⲣⲓⲁ	ⲫⲟⲓⲛⲓⲕⲏ	1
ⲛⲉϥ ⲁⲅⲅⲉⲗⲟⲥ	ⲁⲅⲅⲉⲗⲟⲥ	1
ⲡⲁⲓ ⲉⲧ ϫⲱ ⲛ ⲛⲁⲓ	ⲡⲁⲓ	1
ⲛ ϣⲱⲛⲃ ⲛ ϩⲉⲛ ⲡⲛⲉⲩⲙⲁⲧⲓⲕⲟⲛ	ϣⲱⲛⲃ	1
ⲥⲁϣϥⲉ ⲛ ⲧ ⲟⲩⲱⲧ ⲛ ⲛⲟⲩⲃ	ⲟⲩⲱⲧ	1
ⲁⲃⲣⲁϩⲁⲙ ⲡⲉⲛ ⲉⲓⲱⲧ	ⲁⲃⲣⲁϩⲁⲙ	1
ⲡ ⲙⲁ ⲙ ⲡ ⲥⲁⲧⲁⲛⲁⲥ	ⲙⲁ	1
ⲉⲓⲱⲧ ⲛ ⲛⲉⲧⲛ ⲧⲃⲛⲟⲟⲩⲉ	ⲉⲓⲱⲧ	1
ⲡⲁ ⲡⲉ ⲭⲣⲓⲥⲧⲟⲥ	ⲡⲁ	1
ⲛ ⲟⲃϩⲉ	ⲟⲃϩⲉ	1
ⲡ ⲉⲛⲧ ⲁ ϥ ⲛⲁϩⲙⲉ ⲧ ⲉ ⲡ ⲙⲟⲩ ⲙ ⲙⲉϩⲥⲛⲁⲩ · ⲉⲧⲉ ⲧ ⲅⲉϩⲉⲛⲛⲁ ⲛ ⲥⲁⲧⲉ ⲧⲉ	ⲡ	1
ⲣⲱⲙⲉ ⲛⲓⲙ ⲉⲧⲉ ⲛ ⲥⲉ ⲥⲟⲩⲧⲱⲛ ⲁⲛ	ⲣⲱⲙⲉ	1
ⲛ ϩⲁⲗⲩⲥⲓⲥ	ϩⲁⲗⲩⲥⲓⲥ	1
ⲟⲩ ⲣⲁϩⲧ ⲛ ⲧⲱϭⲥ	ⲣⲁϩⲧ	1
ⲛ ⲗⲁⲁⲩ	ⲗⲁⲁⲩ	1
ϭⲓⲛϭⲗⲱ	ϭⲓⲛϭⲗⲱ	1
ⲛ ⲟⲩⲏⲏⲃ	ⲟⲩⲏⲏⲃ	1
ⲡ ⲣⲉϥϩⲁⲣⲉϩ ⲉ ⲛ ⲉⲧ ϩⲓϫⲙ ⲡ ⲕⲁϩ · ⲧⲉ ⲭⲁⲣⲓⲥ · ⲁⲩⲱ ⲡ ⲣⲁϣⲉ ⲛ ⲛ ⲉⲧⲉ ⲛⲟⲩⲃ ⲛⲉ	ⲣⲉϥϩⲁⲣⲉϩ	1
ⲛ ⲙⲧⲟⲛ	ⲙⲧⲟⲛ	1
ⲗⲁⲁⲩ ⲛ ϩⲛⲟ	ⲗⲁⲁⲩ	1
ⲛⲉϥ ⲁⲅⲁⲑⲟⲛ	ⲁⲅⲁⲑⲟⲛ	1
ⲡ ⲙⲁ ⲉⲧ ⲕ ϣⲱⲛⲉ ⲉⲣⲟ ϥ	ⲙⲁ	1
ⲡⲉ ϩⲙⲟⲙ	ϩⲙⲟⲙ	1
ⲡⲉ ϩⲙⲟⲧ	ϩⲙⲟⲧ	1
ⲡ ⲉⲛⲧ ⲁ ⲛ ⲁⲡⲟⲧⲁⲥⲥⲉ ⲙⲙⲟ ϥ	ⲡ	1
ⲛ ⲟⲉⲓⲕ	ⲟⲉⲓⲕ	1
ⲛ ⲟⲩⲱⲛ	ⲟⲩⲱⲛ	1
ⲡⲉ ϭⲣⲟϭ	ϭⲣⲟϭ	1
ⲧ ⲙⲛⲧⲣⲣⲟ ⲛ ⲙ ⲡⲏⲩ̣ⲉ	ⲙⲛⲧⲣⲣⲟ	1
ⲛ ⲥⲓⲟⲩ	ⲥⲓⲟⲩ	1
ⲛ ⲥⲱⲧⲉ	ⲥⲱⲧⲉ	1
ⲛ ⲧⲃⲃⲟ	ⲧⲃⲃⲟ	1
ⲟⲩ ⲡⲛⲉⲩⲙⲁ ⲉ ϥ ⲟⲩⲁⲁⲃ	ⲡⲛⲉⲩⲙⲁ	1
ⲛ ⲧⲟⲟⲩ	ⲧⲟⲟⲩ	1
ⲡⲉ ϫⲛⲟⲟⲩ	ϫⲛⲟⲟⲩ	1
ⲛ ⲧⲱⲧⲉ	ⲧⲱⲧⲉ	1
ⲧⲉϥ ⲙⲁⲛⲓⲁ	ⲙⲁⲛⲓⲁ	1
ⲛⲁ ⲧ ϩⲓⲉⲣⲟⲥⲟⲗⲩⲙⲁ ⲧⲏⲣ ⲟⲩ	ⲛⲁ	1
ⲙⲉⲗⲟⲥ ⲙ ⲡⲉ ⲭⲣⲓⲥⲧⲟⲥ	ⲙⲉⲗⲟⲥ	1
ⲟⲩ ϩⲏⲧ ⲛ ⲟⲩⲱⲧ	ϩⲏⲧ	1
ⲟⲩ ϫⲣⲟⲡ ⲉ ⲁ ϥ ϣⲱⲡⲉ ϩⲓ ⲧ ⲟⲩⲉⲣⲏⲧⲉ ⲛ ⲟⲩⲁ ⲉ ⲙⲛ ϭⲟⲙ ⲙⲙⲟ ϥ ⲉ ⲙⲟⲟϣⲉ ⲉ ⲉⲓ ⲉⲃⲟⲗ	ϫⲣⲟⲡ	1
ϩⲱⲃ ⲛⲓⲙ ⲉⲧⲉ ⲣ ⲁ ϫⲟⲟ ⲩ ⲉⲣⲟ ⲓ	ϩⲱⲃ	1
ⲡ ⲉⲧ ⲛⲁ ϣⲟⲡ ⲧ ⲉⲣⲟ ϥ	ⲡ	1
ϩⲉⲛ ⲡⲣⲟⲥⲫⲟⲣⲁ · ⲛⲁⲓ ⲉ ϣⲁⲣⲉ ⲛ ϩⲏⲕⲉ ⲥⲁⲛϣ ⲉⲃⲟⲗ ⲛϩⲏⲧ ⲟⲩ	ⲡⲣⲟⲥⲫⲟⲣⲁ	1
ⲧ ⲁⲡⲁⲧⲏ ⲛ ⲧ ⲙⲛⲧⲣⲙⲙⲁⲟ	ⲁⲡⲁⲧⲏ	1
ⲡ ⲉⲓⲱⲧ ⲙ ⲡ ϣⲏⲣⲉ ϣⲏⲙ	ⲉⲓⲱⲧ	1
ⲧⲉⲕ ϩⲓⲏ	ϩⲓⲏ	1
ⲡ ⲕⲉ ⲕⲁϩ	ⲕⲁϩ	1
ⲡ ⲕⲉ ⲟⲩⲁ	ⲟⲩⲁ	1
ⲡ ⲕⲉ ⲧⲏⲩ	ⲧⲏⲩ	1
ⲧⲉⲩ ϣⲃⲉⲓⲱ	ϣⲃⲉⲓⲱ	1
ⲡ ⲕⲁⲣⲡⲟⲥ	ⲕⲁⲣⲡⲟⲥ	1
ⲟⲩⲁ ⲙⲙⲁⲩ · ⲉⲣⲉ ⲡ ⲕⲟⲥⲙⲟⲥ ⲧⲏⲣ ϥ ⲙⲡϣⲁ ⲁⲛ ⲛ ⲟⲩ ⲥϣ ⲛ ⲧⲁϭⲥⲉ ⲛ ⲟⲩⲱⲧ · ⲛⲧⲉ ⲛⲉϥ ⲟⲩⲣⲏⲏⲧⲉ	ⲟⲩⲁ	1
ⲟⲩ ⲣⲱⲙⲉ ⲙ ⲙⲟⲛⲁⲭⲟⲥ	ⲣⲱⲙⲉ	1
ⲡ ⲥⲁ ⲙ ⲡ ⲱⲕⲉⲁⲛⲟⲥ	ⲥⲁ	1
ⲡ ϩⲁⲅⲓⲟⲥ · ⲓⲱϩⲁⲛⲛⲏⲥ · ⲡ ⲉⲩⲁⲅⲅⲉⲗⲓⲥⲧⲏⲥ · ⲁⲩⲱ ⲡ ⲁⲡⲟⲥⲧⲟⲗⲟⲥ ⲙ ⲡⲉ ⲭⲣⲓⲥⲧⲟⲥ	ⲓⲱϩⲁⲛⲛⲏⲥ	1
ϩⲱⲃ ⲅⲁⲣ ⲛⲓⲙ ⲉⲧ ⲟⲩⲟⲛϩ ⲉⲃⲟⲗ	ϩⲱⲃ	1
ⲡ ϫⲟⲉⲓⲥ · ⲧ ⲛⲟⲩⲛⲉ ⲛ ⲧ ⲙⲛⲧⲁⲧⲙⲟⲩ · ⲁⲩⲱ ⲧ ⲡⲏⲅⲏ ⲛ ⲧ ⲙⲛⲧⲁⲧⲧⲁⲕⲟ · ⲁⲩⲱ ⲡ ⲧⲁϫⲣⲟ ⲛ ⲛ ⲁⲓⲱⲛ	ϫⲟⲉⲓⲥ	1
ⲡ ⲣⲟⲟⲩϣ ⲙ ⲡ ⲁⲓⲱⲛ	ⲣⲟⲟⲩϣ	1
ⲡⲉ ⲥⲧⲁⲩⲣⲟⲥ	ⲥⲧⲁⲩⲣⲟⲥ	1
ⲛ ϣⲁϫⲉ ⲛⲧ ⲁ ⲛⲉ ⲡⲣⲟⲫⲏⲧⲏⲥ ϫⲟⲟⲩ ⲥⲉ ⲛⲁ ⲩ ϩⲙ ⲡ ⲣⲁⲛ ⲙ ⲡ ⲛⲟⲩⲧⲉ	ϣⲁϫⲉ	1
ⲡ ⲙⲟⲩ ⲉⲧ ⲥⲁϣⲉ	ⲙⲟⲩ	1
ⲡ ⲛⲟⲩⲧⲉ ⲛ ⲛ ϭⲟⲙ ⲡ ⲡⲁⲛⲧⲟⲕⲣⲁⲧⲱⲣ	ⲛⲟⲩⲧⲉ	1
ⲛⲉⲧⲛ ϩⲃⲏⲩⲉ ⲧⲏⲣ ⲟⲩ	ϩⲃⲏⲩⲉ	1
ⲛⲉ ⲥⲛⲏⲩ ⲉⲧ ϩⲙ ⲡ ⲙⲁ ⲛⲙⲙ ⲉ	ⲥⲛⲏⲩ	1
ⲕⲁⲣⲡⲟⲥ	ⲕⲁⲣⲡⲟⲥ	1
ⲛ ϭⲓϫ ⲛ ⲟⲩ ⲣⲱⲙⲉ ⲛ ⲥⲁⲃⲉ	ϭⲓϫ	1
ⲛⲁ ⲡⲉϥ ⲏⲓ ⲧⲏⲣ ⲟⲩ	ⲛⲁ	1
ϩⲉⲛ ⲁϩⲟ ϩⲛ ⲧ ⲡⲉ	ⲁϩⲟ	1
ⲡⲉ ⲟⲩⲟⲉⲓϣ ⲙ ⲡ ⲱϩⲥ	ⲟⲩⲟⲉⲓϣ	1
ⲡⲉⲕ ϫⲁϫⲉ ⲇⲉ ϩⲱⲱ ϥ ⲉⲧ ⲣⲛⲟⲃⲉ ⲉⲣⲟ ⲕ	ϫⲁϫⲉ	1
ⲛ ⲣⲉⲙⲏⲧ	ⲣⲉⲙⲏⲧ	1
ⲡ ⲃⲓⲟⲥ ⲁⲩⲱ ⲧ ⲡⲟⲗⲓⲧⲉⲓⲁ ⲙ ⲡⲉⲛ ⲡⲉⲧⲟⲩⲁⲁⲃ ⲛ ⲉⲓⲱⲧ ⲉⲧ ⲧⲁⲓⲏⲩ ⲕⲁⲧⲁ ⲥⲙⲟⲧ ⲛⲓⲙ ⲡ ϩⲁⲅⲓⲟⲥ ⲁⲡⲁ ⲕⲩⲣⲟⲥ · ⲡ ⲧⲉⲗⲓⲟⲥ ⲛⲁⲙⲉ ⲛⲧ ⲁ ϥ ϩⲓⲥⲧⲟⲣⲓⲍⲉ ⲙⲙⲟ ϥ · ⲛϭⲓ ⲁⲡⲁ ⲡⲁⲙⲃⲱ ⲡⲉ ⲡⲣⲉⲥⲃⲩⲧⲉⲣⲟⲥ ⲛ ⲧ ⲉⲕⲕⲗⲏⲥⲓⲁ ⲛ ϣⲓⲏⲧ ⲛⲧ ⲁ ϥ ⲙⲧⲟⲛ ⲙⲙⲟ ϥ ⲛϭⲓ ⲡ ⲉⲧ ⲟⲩⲁⲁⲃ · ⲁⲡⲁ ⲕⲩⲣⲟⲥ ϩⲛ ⲥⲟⲩϣⲙⲟⲩⲛ ⲙ ⲡ ⲉⲃⲟⲧ ⲉⲡⲏⲡ ϩⲛ ⲟⲩ ⲉⲓⲣⲏⲛⲏ ⲛⲧⲉ ⲡ ⲛⲟⲩⲧⲉ	ⲃⲓⲟⲥ	1
ⲥⲁϣϥ ⲛ ϣϥⲉ ⲛ ⲥⲟⲡ	ⲥⲟⲡ	1
ⲟⲩ ⲡⲣⲟⲫⲏⲧⲏⲥ	ⲡⲣⲟⲫⲏⲧⲏⲥ	1
ⲡ ⲇⲁⲓⲙⲱⲛ	ⲇⲁⲓⲙⲱⲛ	1
ⲡⲉⲕ ⲙⲁ ⲛ ϣⲱⲱⲡⲉ	ⲙⲁ	1
ⲣⲉϥⲧⲱⲣⲡ	ⲣⲉϥⲧⲱⲣⲡ	1
ⲡ ⲣⲱⲙⲉ ⲉⲧ ⲥⲙⲁⲙⲁⲁⲧ	ⲣⲱⲙⲉ	1
ⲡ ⲓⲟⲣⲇⲁⲛⲏⲥ ⲡ ⲓⲉⲣⲟ	ⲓⲟⲣⲇⲁⲛⲏⲥ	1
ⲡ ⲉⲓⲱⲧ ⲛ ⲓⲉⲥⲥⲁⲓ ⲡ ⲉⲓⲱⲧ ⲛ ⲇⲁⲩⲉⲓⲇ	ⲉⲓⲱⲧ	1
ⲟⲩ ⲙⲛⲧⲣⲣⲟ	ⲙⲛⲧⲣⲣⲟ	1
ⲡ ϣⲁ	ϣⲁ	1
ⲡ ϣⲓ	ϣⲓ	1
ϩⲁⲣⲉϩ ⲛⲓⲙ	ϩⲁⲣⲉϩ	1
ⲡⲁ ⲡ ⲉⲧ ⲧⲱϭⲉ	ⲡⲁ	1
ⲛ ⲣⲣⲱⲟⲩ	ⲣⲣⲱⲟⲩ	1
ⲛ ⲥⲱ	ⲥⲱ	1
ⲧ ϫⲟ	ϫⲟ	1
ϩⲣⲁⲃⲃⲉⲓ	ϩⲣⲁⲃⲃⲉⲓ	1
ⲧⲁ ⲭⲣⲉⲓⲁ	ⲭⲣⲉⲓⲁ	1
ⲛ ⲕⲉ ⲥⲉⲉⲡⲉ ⲙ ⲙⲏⲏϣⲉ	ⲥⲉⲉⲡⲉ	1
ϣⲃⲃⲓⲱ	ϣⲃⲃⲓⲱ	1
ⲧ ⲧⲟⲉⲓⲥ ⲉⲧⲉⲣⲉ ⲛ ⲟⲩⲁⲙⲟⲙⲉ ϩⲓⲱⲱ ⲥ	ⲧⲟⲉⲓⲥ	1
ϣⲃⲛⲛⲉ	ϣⲃⲛⲛⲉ	1
ⲡⲉ ⲫⲁⲣⲓⲥⲥⲁⲓⲟⲥ	ⲫⲁⲣⲓⲥⲥⲁⲓⲟⲥ	1
ⲟⲩ ⲥⲁⲛⲇⲁⲗⲓⲟⲛ	ⲥⲁⲛⲇⲁⲗⲓⲟⲛ	1
ϩⲩⲡⲟⲕⲣⲓⲛⲉ	ϩⲩⲡⲟⲕⲣⲓⲛⲉ	1
ⲇⲁⲛⲓⲏⲗ	ⲇⲁⲛⲓⲏⲗ	1
ⲙⲉⲉⲩⲉ ⲛⲓⲙ ⲉ ϥ ϫⲁϩⲙ ⲛⲧⲉ ⲡ ⲇⲓⲁⲃⲟⲗⲟⲥ	ⲙⲉⲉⲩⲉ	1
ⲓⲏⲥⲟⲩⲥ ⲡⲉ ⲭⲣⲓⲥⲧⲟⲥ ⲁⲩⲱ ⲡⲁⲓ ⲉ ⲁ ⲩ ⲥⲧⲁⲩⲣⲟⲩ ⲙⲙⲟ ϥ	ⲓⲏⲥⲟⲩⲥ	1
ⲛⲉϥ ⲥⲩⲛⲁⲅⲱⲅⲏ	ⲥⲩⲛⲁⲅⲱⲅⲏ	1
ⲛⲉⲓ ⲟⲩⲟⲧⲟⲩⲉⲧ ⲉⲧ ⲟϣ	ⲟⲩⲟⲧⲟⲩⲉⲧ	1
ⲡ ⲙⲧⲟ ⲉⲃⲟⲗ ⲙ ⲡ ⲛⲟⲩⲧⲉ	ⲙⲧⲟ	1
ⲛ ⲕⲟⲟⲩⲉ ⲧⲏⲣ ⲟⲩ · ⲛⲧ ⲁ ⲧⲉⲧⲛ ⲛⲁⲩ ⲉⲣⲟ ⲟⲩ ϩⲛ ⲛⲉⲧⲛ ⲃⲁⲗ	ⲕⲟⲟⲩⲉ	1
ⲁⲡⲁ ⲃⲉⲛⲓⲁⲙⲓⲛ	ⲃⲉⲛⲓⲁⲙⲓⲛ	1
ⲡⲉ ϩⲟⲟⲩ ⲙ ⲡⲁ ⲙⲟⲩ	ϩⲟⲟⲩ	1
ⲡ ⲉⲟⲟⲩ ⲙ ⲡⲉ ⲥⲧⲉⲣⲉⲱⲙⲁ	ⲉⲟⲟⲩ	1
ⲛⲉ ⲡⲣⲟⲫⲏⲧⲏⲥ ⲧⲏⲣ ⲟⲩ	ⲡⲣⲟⲫⲏⲧⲏⲥ	1
ⲡ ⲡⲉⲧⲟⲩⲁⲁⲃ · ⲓⲱϩⲁⲛⲛⲏⲥ	ⲓⲱϩⲁⲛⲛⲏⲥ	1
ⲡ ⲉⲥⲏⲧ ⲛ ⲍⲱⲛⲧ ⲛⲓⲙ	ⲉⲥⲏⲧ	1
ⲡ ⲧⲱⲙ ⲛ ϩⲏⲧ ⲙ ⲡⲉⲩ ϩⲏⲧ	ⲧⲱⲙ	1
ⲛ ⲉⲧ ϥ ⲟⲩⲁϣ ⲟⲩ	ⲛ	1
ⲁⲡⲁ ϩⲩⲡⲉⲣⲉⲭⲓⲟⲥ	ϩⲩⲡⲉⲣⲉⲭⲓⲟⲥ	1
ⲡⲉ ⲥϯⲛⲟⲩϥⲉ ⲙ ⲡ ⲥⲟⲛ ⲉⲧ ⲙⲙⲁⲩ	ⲥϯⲛⲟⲩϥⲉ	1
ϣⲡⲏⲣⲉ	ϣⲡⲏⲣⲉ	1
ⲡ ⲕⲁⲕⲉ ⲉⲧ ϩⲓⲃⲟⲗ	ⲕⲁⲕⲉ	1
ⲡⲉ ⲡⲛⲉⲩⲙⲁ ⲙ ⲡⲉⲛ ⲛⲟⲩⲧⲉ	ⲡⲛⲉⲩⲙⲁ	1
ⲡ ⲣⲱⲙⲉ ⲇⲉ ⲉⲧ ⲙⲙⲁⲩ	ⲣⲱⲙⲉ	1
ⲙ ⲙⲁⲓⲛⲟⲩⲧⲉ	ⲙⲁⲓⲛⲟⲩⲧⲉ	1
ⲡ ⲟⲩϫⲁⲓ ⲙ ⲡⲉ ⲥϣϥⲉ ⲛ ⲛⲟⲩⲧⲉ	ⲟⲩϫⲁⲓ	1
ⲛ ⲥⲩⲛⲁⲅⲱⲅⲏ	ⲥⲩⲛⲁⲅⲱⲅⲏ	1
ⲁⲡⲁ ⲡⲁⲙⲃⲱ · ⲡ ⲡⲣⲉⲥⲃⲩⲧⲉⲣⲟⲥ ⲛ ⲧ ⲉⲕⲕⲗⲏⲥⲓⲁ · ⲛ ϣⲓⲏⲧ · ⲁⲩⲱ ⲡ ⲛⲟϭ ⲛ ϫⲟⲓ ⲉⲧ ⲣϩⲱⲧ ϩⲙ ⲡ ϫⲁⲓⲉ ⲛ ⲁⲧⲙⲟⲟⲩ	ⲡⲁⲙⲃⲱ	1
ⲡ ⲡⲉⲧⲟⲩⲁⲁⲃ ⲓⲱϩⲁⲛⲛⲏⲥ ⲡ ⲉⲩⲁⲅⲅⲉⲗⲓⲥⲧⲏⲥ	ⲓⲱϩⲁⲛⲛⲏⲥ	1
ⲟⲩ ⲙⲁⲑⲏⲧⲏⲥ	ⲙⲁⲑⲏⲧⲏⲥ	1
ⲛⲉⲩ ⲙⲛⲧⲁⲡⲟⲥⲧⲟⲥ	ⲙⲛⲧⲁⲡⲟⲥⲧⲟⲥ	1
ⲡ ⲙⲏⲏϣⲉ ⲉⲧ ⲑⲗⲓⲃⲉ ⲙⲙⲟ ⲕ	ⲙⲏⲏϣⲉ	1
ⲡⲁϩⲟⲩ ⲙ ⲡ ϫⲟⲉⲓ	ⲡⲁϩⲟⲩ	1
ϣⲟⲙⲛⲧ ⲛ ⲱⲛⲉ ⲙ ⲙⲉ	ⲱⲛⲉ	1
ⲟⲩ ⲙⲛⲧⲥⲉⲙⲛⲟⲥ	ⲙⲛⲧⲥⲉⲙⲛⲟⲥ	1
ⲛⲉⲕ ⲇⲱⲣⲉⲁ	ⲇⲱⲣⲉⲁ	1
ⲛ ⲁⲡⲓⲥⲧⲟⲥ	ⲁⲡⲓⲥⲧⲟⲥ	1
ϩⲉⲛ ⲕⲉⲉⲥ	ⲕⲉⲉⲥ	1
ⲟⲩ ⲣⲱⲙⲉ ⲉ ϥ ⲥⲟⲃϩ	ⲣⲱⲙⲉ	1
ϩⲉⲛ ⲕⲟⲩⲓ	ⲕⲟⲩⲓ	1
ⲡ ⲙⲁ ⲇⲉ ⲉⲧ ⲙⲙⲁⲩ ϩⲁⲣⲁⲧ ϥ ⲙ ⲡ ⲧⲟⲟⲩ	ⲙⲁ	1
ⲛ ⲉⲛⲧ ⲁ ⲩ ⲁⲁ ⲩ ⲧⲏⲣ ⲟⲩ	ⲛ	1
ϩⲉⲛ ⲣⲉϥϣⲙϣⲉⲉⲓⲇⲱⲗⲟⲛ	ⲣⲉϥϣⲙϣⲉⲉⲓⲇⲱⲗⲟⲛ	1
ⲧ ⲙⲛⲧⲣⲣⲟ ⲉⲛⲧ ⲁ ⲩ ⲥⲃⲧⲱⲧ ⲥ ⲛⲏ ⲧⲛ ϫⲓⲛ ⲛ ⲧ ⲕⲁⲧⲁⲃⲟⲗⲏ ⲙ ⲡ ⲕⲟⲥⲙⲟⲥ	ⲙⲛⲧⲣⲣⲟ	1
ⲟⲩ ⲣⲉϥⲙⲟⲟⲩⲧ	ⲣⲉϥⲙⲟⲟⲩⲧ	1
ⲧⲉⲛ ⲙⲏⲏⲧⲉ	ⲙⲏⲏⲧⲉ	1
ϩⲉⲛ ⲥⲱϣⲉ	ⲥⲱϣⲉ	1
ⲡⲁⲓ ⲛⲧ ⲁ ϥ ⲥⲙⲟⲩ ⲉ ⲁⲃⲣⲁϩⲁⲙ ⲙⲛ ⲓⲥⲁⲁⲕ ⲙⲛ ⲓⲁⲕⲱⲃ · ⲙⲛ ⲛ ϣⲏⲣⲉ	ⲡⲁⲓ	1
ϩⲉⲛ ⲡⲏⲅⲏ ⲙ ⲙⲟⲟⲩ	ⲡⲏⲅⲏ	1
ⲡ ϫⲟⲉⲓⲥ ⲉⲛⲧ ⲁ ⲕ ϫⲓⲟⲩⲁ ⲉⲣⲟ ϥ	ϫⲟⲉⲓⲥ	1
ϩⲉⲛ ⲣⲱⲙⲉ	ⲣⲱⲙⲉ	1
ϩⲉⲛ ⲥⲁⲃⲉ	ⲥⲁⲃⲉ	1
ϩⲉⲛ ⲥⲙⲟⲩ	ⲥⲙⲟⲩ	1
ϩⲉⲛ ⲥⲟⲃⲧ	ⲥⲟⲃⲧ	1
ϩⲉⲛ ⲥⲟⲩⲟ	ⲥⲟⲩⲟ	1
ϩⲉⲛ ⲧⲱⲣⲉ	ⲧⲱⲣⲉ	1
ϩⲁϩ ⲛ ⲇⲩⲛⲁⲧⲟⲥ	ⲇⲩⲛⲁⲧⲟⲥ	1
ⲛ ⲧⲁⲉⲓⲟ	ⲧⲁⲉⲓⲟ	1
ϩⲉⲛ ϩⲓⲥⲉ ⲛ ⲇⲓⲕⲁⲓⲟⲛ	ϩⲓⲥⲉ	1
ⲡ ⲉⲛⲧ ⲁ ϥ ϣⲱⲡⲉ ⲙⲙⲟ ⲥ	ⲡ	1
ⲟⲩ ⲉⲡⲓⲥⲧⲏⲙⲏ ϩⲙ ⲡ ⲧⲣⲉ ⲡⲁⲣⲁⲃⲁ ⲛ ⲧ ⲉⲛⲧⲟⲗⲏ	ⲉⲡⲓⲥⲧⲏⲙⲏ	1
ⲛⲉϥ ⲁⲅⲅⲉⲗⲟⲥ ⲉⲧ ⲟⲩⲁⲁⲃ ⲉⲧ ϥⲓ ϩⲁⲣⲟ ⲛ ϫⲓⲛ ⲧ ⲁⲣⲭⲏ ⲙ ⲡ ⲥⲱⲛⲧ ϣⲁϩⲣⲁⲓ ⲉ ⲡ ϩⲟⲟⲩ ⲛ ϩⲟⲟⲩ ⲁⲩⲱ ⲟⲛ ϣⲁ ⲉⲛⲉϩ	ⲁⲅⲅⲉⲗⲟⲥ	1
ⲟⲩ ϩⲱⲃ ⲡⲉ ⲡⲁⲣⲁ ⲡ ⲛⲟⲙⲟⲥ	ϩⲱⲃ	1
ⲙ ⲙⲉⲗⲟⲥ ⲙ ⲡⲟⲣⲛⲏ	ⲙⲉⲗⲟⲥ	1
ⲧ ϯⲙⲏ ⲛ ⲟⲩ ⲥⲟⲡ ⲛ ⲟⲩⲱⲧ ⲛⲧⲉ ⲡ ⲉⲓⲇⲟⲥ	ϯⲙⲏ	1
ⲛⲉⲕ ⲉⲓⲟⲧⲉ	ⲉⲓⲟⲧⲉ	1
ⲡⲉϥ ⲙⲉⲉⲩⲉ ⲙⲁⲩⲁⲁ ϥ	ⲙⲉⲉⲩⲉ	1
ⲟⲩ ⲛⲟϭ ⲛ ⲃⲟⲙⲱⲥ ⲛ ϩⲁⲧ	ⲃⲟⲙⲱⲥ	1
ⲧⲉⲛ ϩⲁⲏ	ϩⲁⲏ	1
ⲛⲉⲧⲛ ϩⲓⲥⲉ ⲧⲏⲣ ⲟⲩ	ϩⲓⲥⲉ	1
ⲣⲉϥⲕⲁⲥⲕⲥ ⲛ ⲣⲉϥⲕⲁⲧⲁⲗⲁⲗⲉⲓ	ⲣⲉϥⲕⲁⲥⲕⲥ	1
ⲡ ⲛⲁⲩ ⲉⲧ ⲕ ⲛⲁ ⲥⲱⲧⲙ	ⲛⲁⲩ	1
ⲟⲩ ⲇⲱⲣⲟⲛ ⲉ ϥ ⲟⲩⲁⲁⲃ	ⲇⲱⲣⲟⲛ	1
ⲧ ⲁⲣⲧⲉⲙⲓⲥ	ⲁⲣⲧⲉⲙⲓⲥ	1
ⲗⲁⲁⲩ ⲛ ⲁϣ	ⲗⲁⲁⲩ	1
ⲛⲁⲓ ⲉⲛⲧ ϥ ϫⲟⲟ ⲥ ⲛⲁ ⲩ ⲉϥϣⲁⲛ ⲉⲓ ⲛϭⲓ ⲡ ⲣⲣⲟ	ⲛⲁⲓ	1
ⲧⲉϥ ⲟⲩⲟϭⲉ	ⲟⲩⲟϭⲉ	1
ⲛ ⲉⲧ ⲑⲗⲓⲃⲉ ⲙⲙⲟ ⲟⲩ	ⲛ	1
ⲡ ϩⲱⲃ ⲛ ⲛⲉⲕ ϭⲓϫ	ϩⲱⲃ	1
ⲛ ⲧⲟⲉⲓⲥ	ⲧⲟⲉⲓⲥ	1
ⲙⲛⲧⲥⲛⲟⲟⲩⲥ ⲛ ⲕⲟⲧ ⲉ ⲩ ⲙⲉϩ ⲛ ⲗⲁⲕⲙ	ⲕⲟⲧ	1
ⲡⲉ ⲡⲛⲉⲩⲙⲁ ⲡ ⲉⲃⲟⲗ ⲙ ⲡ ⲛⲟⲩⲧⲉ	ⲡⲛⲉⲩⲙⲁ	1
ⲛ ⲧⲟⲩⲓⲏ	ⲧⲟⲩⲓⲏ	1
ⲟⲩ ⲙⲟⲧⲛⲉⲥ	ⲙⲟⲧⲛⲉⲥ	1
ⲡⲉϥ ⲥⲁⲛⲇⲁⲗⲓⲟⲛ	ⲥⲁⲛⲇⲁⲗⲓⲟⲛ	1
ⲛ ⲉⲧⲉ ⲟⲩⲛⲧⲁ ⲩ ⲓⲏⲥⲟⲩⲥ ϩⲛ ⲟⲩ ⲙⲉ	ⲛ	1
ⲧ ⲕⲉ ⲕⲣⲁⲥⲓⲥ ⲙ ⲡ ⲁⲏⲣ	ⲕⲣⲁⲥⲓⲥ	1
ⲛ ⲉⲧ ϩⲙ ⲡⲁ ϩⲏⲧ ⲧⲏⲣ ⲟⲩ	ⲛ	1
ⲟⲩⲁ ⲉ ⲙⲛ ϭⲟⲙ ⲙⲙⲟ ϥ ⲉ ⲙⲟⲟϣⲉ ⲉ ⲉⲓ ⲉⲃⲟⲗ	ⲟⲩⲁ	1
ⲟⲩ ϣⲧⲟⲣⲧⲣ	ϣⲧⲟⲣⲧⲣ	1
ⲡ ⲁϩⲟ ⲙ ⲡ ⲙⲟⲛⲁⲭⲟⲥ	ⲁϩⲟ	1
ⲡⲉⲥ ϣⲏⲣⲉ	ϣⲏⲣⲉ	1
ⲟⲩⲁ ⲛⲓⲙ ⲉⲧ ⲟⲩ ⲛⲁ ϫⲟⲟ ⲩ ⲛϭⲓ ⲛ ϣⲏⲣⲉ ⲛ ⲛ ⲣⲱⲙⲉ	ⲟⲩⲁ	1
ⲛⲉⲕ ϩⲃⲏⲩⲉ ⲧⲏⲣ ⲟⲩ	ϩⲃⲏⲩⲉ	1
ⲡ ⲧⲙ ⲕⲁ ⲗⲁⲁⲩ ⲛⲁ ⲛ	ⲕⲁ	1
ⲟⲩ ⲉⲕⲥⲧⲁⲥⲓⲥ	ⲉⲕⲥⲧⲁⲥⲓⲥ	1
ⲛ ⲉⲛⲧ ⲁ ϥ ⲧⲁⲗϭⲟ ⲟⲩ	ⲛ	1
ⲟⲩ ⲁⲅⲁⲑⲟⲛ ⲛ ϩⲟⲩⲟ ⲡⲉ ⲉ ϥ ϫⲏⲕ ⲉⲃⲟⲗ	ⲁⲅⲁⲑⲟⲛ	1
ⲡⲉⲕ ⲉⲓⲱⲧ	ⲉⲓⲱⲧ	1
ⲡⲉⲕ ⲉⲣⲏⲧ	ⲉⲣⲏⲧ	1
ⲛ ⲉⲧⲉⲣⲉ ⲡ ⲛⲟⲩⲧⲉ ⲕⲧⲟ ⲙⲙⲟ ⲟⲩ ⲉϩⲟⲩⲛ ⲉ ⲩ ⲙⲛⲧⲣⲉϥϣⲙϣⲉⲛⲟⲩⲧⲉ	ⲛ	1
ⲛ ⲭⲓⲗⲓⲁⲣⲭⲟⲥ	ⲭⲓⲗⲓⲁⲣⲭⲟⲥ	1
ⲡ ⲛⲟⲩⲧⲉ ⲡ ⲙⲁⲓⲣⲱⲙⲉ	ⲛⲟⲩⲧⲉ	1
ⲗⲁⲁⲩ ⲛ ⲉⲓⲇⲱⲗⲟⲛ	ⲗⲁⲁⲩ	1
ⲧ ⲁⲫⲟⲣⲙⲏ ⲙ ⲡ ⲙⲏⲏϣⲉ	ⲁⲫⲟⲣⲙⲏ	1
ⲗⲁⲁⲩ ⲉ ϥ ⲙ ⲡ ⲃⲟⲗ ⲙ ⲡ ⲣⲱⲙⲉ ⲉ ϥ ⲛⲁ ⲃⲱⲕ ⲉϩⲟⲩⲛ ⲉⲣⲟ ϥ ⲉ ϥ ⲛⲁ ϣ ϫⲁϩⲙⲉ ϥ	ⲗⲁⲁⲩ	1
ⲡⲉⲕ ⲗⲁⲟⲥ	ⲗⲁⲟⲥ	1
ⲡⲉⲕ ⲙⲁⲕϩ	ⲙⲁⲕϩ	1
ⲟⲩ ⲉⲗⲁⲭⲓⲥⲧⲟⲛ ⲛ ϩⲛⲟ ⲛ ⲟⲩⲱⲙ	ⲉⲗⲁⲭⲓⲥⲧⲟⲛ	1
ⲟⲩ ⲁⲛⲁⲡⲁⲩⲥⲓⲥ	ⲁⲛⲁⲡⲁⲩⲥⲓⲥ	1
ⲡⲉⲕ ⲙⲟⲧⲉ	ⲙⲟⲧⲉ	1
ϥⲧⲟⲟⲩϣⲉ ⲛ ⲕⲉⲣⲱⲛ ⲛ ϩⲁⲧ	ⲕⲉⲣⲱⲛ	1
ⲛ ⲏⲓ ⲛ ⲛ ϩⲉⲗⲗⲏⲛ	ⲏⲓ	1
ⲡ ⲙⲁⲕⲁⲣⲓⲟⲥ ⲁⲡⲁ ⲡⲁⲙⲃⲱ	ⲡⲁⲙⲃⲱ	1
ⲡ ⲣⲁⲛ ⲛ ⲧ ⲟⲩⲓ ⲙⲙⲟ ⲟⲩ	ⲣⲁⲛ	1
ⲛ ⲉⲧ ⲟⲩ ⲉⲓⲣⲉ ⲅⲁⲣ ⲙⲙⲟ ⲟⲩ ⲛ ϫⲓⲟⲩⲉ	ⲛ	1
ⲡⲉⲕ ϩⲣⲏⲣⲉ · ⲉⲧⲉ ⲙⲉ ϥ ϩⲱϭⲃ ϣⲁⲃⲟⲗ	ϩⲣⲏⲣⲉ	1
ⲛⲟⲃⲉ ⲛⲓⲙ ϩⲓ ⲟⲩⲁ ⲛⲓⲙ ⲉⲧ ⲟⲩ ⲛⲁ ϫⲟⲟ ⲩ ⲛϭⲓ ⲛ ϣⲏⲣⲉ ⲛ ⲛ ⲣⲱⲙⲉ	ⲛⲟⲃⲉ	1
ⲟⲩⲟⲛ ⲛⲓⲙ ⲉⲧⲉⲣⲉ ⲡ ⲛⲟⲩⲧⲉ ⲛⲁ ⲧⲱⲧ ⲛ ϩⲏⲧ ⲉⲃⲟⲗ ϩⲓⲧⲟⲟⲧ ⲟⲩ ⲉ ⲧⲣⲉ ϥ ⲣ ϩⲛⲁ ϥ ⲉ ϭⲱ ϩⲛ ⲧⲉⲩ ⲙⲏⲧⲉ	ⲟⲩⲟⲛ	1
ⲛⲁⲓ ⲥⲙⲟⲧ ⲙ ⲡⲁⲣⲁⲃⲟⲗⲏ ⲧⲏⲣ ⲟⲩ	ⲥⲙⲟⲧ	1
ⲡⲉ ⲥⲧⲁⲩⲣⲟⲥ ⲙ ⲡⲉ ⲭⲣⲓⲥⲧⲟⲥ	ⲥⲧⲁⲩⲣⲟⲥ	1
ⲡⲉⲕ ⲟⲩⲱⲙ	ⲟⲩⲱⲙ	1
ⲡ ⲉⲧ ϩⲓⲧ ϩⲓⲧⲟⲩⲱ ⲟⲩ	ⲡ	1
ⲡⲉⲕ ⲧⲃⲃⲟ	ⲧⲃⲃⲟ	1
ⲛ ⲣⲉϥⲣⲛⲟⲃⲉ ⲙ ⲡⲁⲣⲁ ⲟⲩⲟⲛ ⲛⲓⲙ	ⲣⲉϥⲣⲛⲟⲃⲉ	1
ⲛⲉ ϩⲃⲏⲩⲉ ⲉⲧⲉ ⲣ ⲁⲁ ⲩ	ϩⲃⲏⲩⲉ	1
ⲡ ⲕⲁϩ ⲉⲛⲧ ⲁ ⲩ ϫⲡⲟ ⲛϩⲏⲧ ϥ	ⲕⲁϩ	1
ⲛⲉ ⲥⲃⲟⲟⲩⲉ	ⲥⲃⲟⲟⲩⲉ	1
ⲡ ⲙⲁ ⲛ ⲧⲣⲉ ⲩ ⲣϩⲏⲃⲉ ⲛϩⲏⲧ ϥ	ⲙⲁ	1
ⲃⲟⲁⲛⲏⲣⲅⲉⲥ ⲉⲧⲉ ⲡⲁⲓ ⲡⲉ ⲛ ϣⲏⲣⲉ ⲙ ⲡⲉ ϩⲣⲟⲩⲃⲃⲁⲉⲓ	ⲃⲟⲁⲛⲏⲣⲅⲉⲥ	1
